28 24 1 600
baby
27 22 0 23
EADGGAGAGGGGBGGJBAGGF[VAGGGA
DWGGMN[MKNADGGGIGMNGGEGWGJGD
GJGGOPAOLPWGGAWGGOPGGEAGGIGG
GIGGGGWGGDGGGDGGGGGWMKKNGGGG
GGGGFGGVGGGADGGDADGGOLLPGDAG
AGGGGGWAWDGWGGGGWGDGGGGGGGWW
DGBBBGGWGBBGGGBBBGDGBGAGBGGD
GGBAABGGBAABGGBAABGGGBBBGGGG
AGBBBBGGBBBBGGBBBBGGGGYGGGAG
WGBAABGGBDGBGGBAABDGADBDADWW
GGBBBGGGBGDBGGBBBGGWWGBGWDG_
DFHHHHHHHHHHHHHHHHHHHHHHHHH\
CAGACRCCCSWCWADDWSWADDYDDADD
CRCUWTACCTCAASDUDTDRWDWWDRSW
CTCTCTCUCTWRATDTDTATDDUDRTTS
CQCQCQWQCQCQAQDQDQAQDWQDQQQQ
CBBBBCBBBCBBBCBBBBBCBBBDBBB`
CBAABCBCCCBABCCCBCCCBABDBDBC
CBBBBCBBBCBBBCECBCCCBABDBDBC
CBCBCCBCCCBCCACCBCCCBABDBDBC
DBCCBCBBBCBCAAACBCCCBBBDBDBE
FHHHHHHHHHHHHHHHHHHHHHHHHHHX
ZAGWGAWAGWAGAGAAGAGWAWGEAWW]
GWGAWAGWEAWWAWAWEWAGAGAWWGA^
