28 24 0 600
keyhole
_BBBGBGAAAAABBAGGBABABAGBBH[
BBBEBABBBBBBWHABABABBABBA^HH
BBGHHHHHHHHHCHBABABBABHHHHHB
EBCGAGGGBGCFCHABBBBBABHACCCC
GHGHBHGBGHCGBHHHHHHHHHHCCCAC
CHGH`HHHHHHHCGCBGGBCGBCGCCCC
GHCH`GDDDGDHHHHHHHHHHHHCMNCC
CHGHHHHHHHGH\VWWWVWWWVHCOPCC
GHGCHABAAHDHWVWVWVWVWVHCCCMN
CHFGHAAAAHDHWWWVWWWVWVHCYCOP
GCGCHHXXAHGHHHHHHHHHWVHCCCCC
CHHCGCGGDHDGDGDGDGDHWVHCMNCA
GHWGGBGBGHHHHHHHHHGHWCECOPCC
BHHHHHHDGGGDDGGGDHGHCCACCCCC
GACBGGHHHHHWHHHFGHDHCCCCACAC
BRBGGYHDGGDGGDGGDHDHACACCAWD
CQGBGWHGFHHWHHHHHHGHHHHHHHHW
CGGAGGHDGDGDGABAGWDDGGDDGDGZ
GMNCJAHHHHHHGUGRGHHHHHHHHHHW
GOPGICVGAAGHGQGTGBSDADGGAGGA
AGGGGGGBMNBHGGDQDGTDABGAAAGW
AMKKKNGGOPGHBAGDADTGRDGWWWGG
AOLLLPGAGGBHBABGSGQGTABGBGGG
ZGCGCGBFBGGEGFGBQBDGQBGDGWGB
