28 24 2 600
failure
19 8 0 4
5 8 21 23
GGBGGGEGGBGGGGGDGGGGGHAHGGAG
WHHHHHHHHHHHWHHHHHHHBGDGBHBB
GDBDBGAABGBGBHDBDDBHHHHHHHBD
HHHHHHHBGHHHBHZ`DDBDBDBHBADG
GBBBABHGGGHGGHHHHHDDEDBHABGB
BBABBAHCGCGGDGBABHHHDBDHBGAG
ABEBABHGAGHGGDGABH[HBDBHWBBB
AABABBHGUCHBGGHHHHHHHBHHHHHG
BBBBB]HCTGHBABAVGAG]HGHAHAHB
HHHHHHHGQGHGMNBGBMNAHGGDBDGG
AAAAAAAGGCHBOPGCGOPCHBHHHHHH
CCBBBBBBGGHCGCGBAGGBHGCGGBH[
GHHHHHHHEGHGAMKKKNGCHBGYCHHH
GGGAGGBHGEHBBOLLLPGGHCGSGDDW
GMKKNBGHEGHGBGCCGBFBAGGTDECD
BOLLPGAHGEHHHHHHHGHHHFGTWGGD
GGBGGGDHGAGGAGAGBADGFGGTGDWZ
BGGGBJGHBCGABABBGWCCCCGQWGDW
GYVVAIGHHHHHHWHHGHHHHHHHHXHH
WFHHHHGGAABG_GGDGGGHGDGDGGDG
CACACHGSBSADHHHHHHGHGHHHHHHH
CBCACHZQDQEEHCACCHGHDGGDGDGD
CACACHHH\HHHHCACAHGHHHHHAHHG
CCEFCCCCCCCCCCFCCWGH^GDGDGGD
