28 24 4 600
reunion
14 11 18 23
15 12 24 23
14 13 7 11
13 12 0 4
BABBABABABBBBGHGGCWWHBGAABHB
BBBABABBBABABBH``HWWHAABBAH`
ABABABABABBBABHHHHGFHFCBHHG`
BBBBBAABABABBBHGGGGGGGGBWG`G
GABBABBBBBABAAHGFHHHHHFGHHHH
BAABBBABABBBBBHBGG`\HFGGGHG^
BBBAABAABABAABHGFHHHHHHFGHGG
BABBABBBBABBBAHGGGGGBHGAGXB`
BBABBBBABABABBHGFHGGGHHHHHWW
ABABABABBBBBBBHGEHGFGGGGGGGG
BBABBBABBABABAHHHHGHHHHHHGXG
BABBABBGAABABB]GGGGGGEH[XGGG
HHHHHHHHHHHHH]_]HHHHHHHHHHHH
DDDDDDDYDDDDDD]BAABAABBABBAA
DUDDCCDJDCCCCWHBBABBABABBABZ
DQDXCCDIDDDDCWHAABBABABABABA
DDDDDDDDDDDDDDHBBBABBABBABAA
DXDMNDMKKNCMNDHAABABAABAABBA
DDDOPDOLLPYOPCHABABABBBBBAAB
DRDDDYCCCCCCCCHABABABABABABA
DTDCDSCCCXDDCCHBBBABBBBBABAB
DTDCDTCVCCCCYGHAABABBABBBBBB
DQDXDQCCCDJCWGHBBABBABBABBAB
DDDCCCCCDDIDDDHBABGABBABGBBB
