28 24 0 600
diverge
BBBBDD`BBFBBFBBBBB`DDDFBBF[B
BBBBFFFBBBBBBXFFBFBBBBBBB[FB
FBBFFBBBFXFFBFFBFFBFFBFBBFBB
BBFBBBBFBBBFBBBBBFBBBBBFBBBB
BBBBBFBBBBBBBFFBBFFFBBBBFFBB
ZBBYB[BFFBBBBB[FBBABBBBBBBFB
BBFFFFFFBBFFBFFFBFFFGBBBBBBB
BBFBBFBBBBBBBBBBBBBFFBFFBBBB
BBFFZFDBBFBD`DBBBFBBFBBBBFBB
BFFBBFDBBFBBFFBBFBBBFBBBBFBF
ZBFBBF`BBBBBBBFBBBBBFBD`DFBF
BBBBBFFFBFBBBFFFFBFBXFFFFFBB
BBFBBBFBBFBBF\FXBBBBFBBBBFBB
XBFBBBFBFFBFFBFFBFFBFYGDDFBF
BBFBBBBBBBBBBBFBBBBBBW`FDFBB
BBFBBBBBXBBBF[FBBBBBFBBBBFBB
BBFBFFBFFBFFFFFBFFBFFBFFBFBB
BGY[FBBBBBBBFBFBBBBBB[FBBBBB
F^FFFBBBBBBBFBBBBFFDDFFBBFBF
BBFBBBBFBFBBFBBBBBF`BBBBBBBB
BBFBBFFDBFFFFBBBFBBBBBBBYBBX
BBXBBFB`DBBBBBBBBBBBBFWZ_FBB
BFBBBFBFFBFBFFBBBBFBBBFFBFBB
BBBBBBBBBBBBBBBBBBBBBBBBBBBB
