28 24 1 600
future
19 11 0 3
BAGAGBGFFEEEHGGGFGGGHAAYABGC
ABBBBBABF\FEHGFGGGF[HBBBBBHG
BGABGABBFFEEHGGHHHHHHHHHHHHC
GAAGBABGEEEHHBBHGGCGCGGGCGGG
CBAABBGHHHHHBBHHEHHHHHHHHHHH
GHHHHHHHGGGGGGGGGHBGGBAGBGDG
GCGGCGGHGHHHHHHHHHGGBRVSGACB
RVVVVSGHGHEGDGGDGGAYGTQUDBGD
TQQQQUCHWHWHHHHHHHWWBABGDRSG
GGGGGGGGDGGGDDGGGGGHGBGGBTUG
GHHHHHHHHHHHHHHHHGHHHHHHHHHX
GGBAGGGDGBGGDGBGHGH]HG[MNAGG
DGMNDBMNGDBMNGDGHGH`HGGIJBDG
GBIJGGIJGGGIJBGBHGH`HHHIJGGB
GAIJBGIJBGGIJGGGHDHGGGGIJBGD
BCIJGGKLGGGIJBAGHGHHHHWKLFXG
BGKLBGGGGBAKLGWGHGGGGGGGGGGD
GGGGMNCCGGCGGGWGHGHAAAARVSAB
GAAGIJGBGMNGCGWGHBHEBBBTQUCG
BBWGIJGGCIJBGMNGHGHHHFCGCGGC
GMNBIJBGGIJGGIJZHBBAGHWWHHHH
GIJFKLGACIJGEIJZHGBABHHHHGAZ
GIJABCBYGIJDGIJZHGABAGDGAGHH
BKL_AGFDGKLBBKLBHBDGDGFGD^H[
