28 24 3 600
oracles
15 7 0 15
13 7 27 15
9 20 0 5
GEGAEBAGBGBADGEGBBABAGBGBGAB
DAEBGGBAGADBAAGBABDEBDBAD\DB
GBGBABGBBAGGEBDGAGADAGDEAGEA
GDAGEGABGEBADGABBBAGBBADBBDB
EGBBABEAGADBBDBDAGEDEDEGAADA
GEADEGBEBEEAGBAGEBGABABDBDBD
HHHHHHHHHHHHHHHHHHHHHHHHHHHH
GGGXCABGCABGX]G]XGBCACAGXCGG
GHGXCBCAGBGCGHGHBACABGBCXGHG
GHGXGYGBBACABHGHGBACBCABXGHC
GHGGBBCAGBGBGHGH^GBGAGBCGGHG
GHHHHHHHHHHHHHGHHHHHHHHHHHHC
GGGFGGGB`GGG`HGH`GGG`BGBFGGG
GHGBFGGBGRVSGHGHGRVSGBGFBGHC
BHGFBFGBGTQUGHGHGTQUGBGGFGHB
GHGGGGGB`GGG`HGH`GGG`BGGGGHG
HHHHHHHHHHHHHHWHHHHHHHHHHHHH
DGAAAGAGGGGGGGGGGAGGWGGGGGAG
GBBEBEBBHHHHHHGHBMNGWGWWGMNB
DRVVVVVSGGGGBHGHGIJGWGWBGIJG
GRQBQVQSG]CACHGHGIJGWZWGEIJG
DRVGGDGGDGGYGHGHGIJGWWWEGIJG
GTQVQVQUGHHHGHEHAKLGGFGAAKLG
DGDGDDDGDGBHGH_HBGGGGGBBBGGB
