28 24 1 600
dancing
25 11 1 23
GGGAGAGGBAGGGGGAGGBHEHBACFBC
BGACCCBAACGGHOAAARVVVVVSCGFG
GCBGGGGBBGGHHBBBBTQWWWQUGDFD
GGGB[GGGGGHHBABGGBB[BGGGFGGG
BAG[E[GCABHGGABGGB\YGGAGGDFB
HHHHHHHHHHHBGWGGGGCCGBYFDRVS
^D`CAGBABGBHHHCBCGGGBGFBGTQU
D`ABABADBADDGH_BGBGAGF[GBGGG
ABBGDGBADBDGAHBGGFFFFFFFFGFG
HHHHHHDBADGBXBGGFDGDGADBFDGD
BBABBHHHHHHHBGGFDGDGADGDFYDG
CCBGCGGBCGBGGCFGGGAGDGDGF]DF
GGGYRVSGBCBGGFABDGXGGGGBFGGD
CBGWTWUCBGGCFDBGGGGGDGBAFGFB
MNGGBBGGGGGFG`DG`GG`GBBBFGBG
IJBCGGCXGDFFFFFFFFFFFFXFFDGD
IJBGBGGGGDBABAGBAGAGAXGFFGDB
KLCBGGGGGGBABBAGBABBZFGGGGGD
HHHHHHHHHHHHHHHHHHHHHHHHHHHX
FGGBGFMNAGBBGBBGBGBAGAGABGDB
EBMNGBIJABCBACGACABBCBACAAC`
FGIJFGIJBCCBABBBABAGAGAGBBAB
BBIJBGKLGABGBCAGBBBCABCAGACG
FGKLFBGGEBAGAGBXABCGCBBC`CAB
