28 24 4 600
bananas
5 15 11 14
15 11 0 19
26 20 5 17
17 14 0 11
ACBH[BA[BBBBHYWBHBG[HBBHWWWW
CAAHZDDGDGDGHFGFHGBGH[GHAAAA
CCCHHHHHHHHXHHXHHXHHHHXHC\AA
CACCCBHDGGDBGDBDGBGDBGYGDFCD
CBCCACHGDDDGDGDDDGGDDDDDDDDF
BHAOOCHHGFHGHFGHHFHHFDDDMNDD
BHBCCCHGAGGWDGDDGFGFBHDFIJFD
GHCACAHDFDFBDFBFDGBDGHDDIJDD
BHCBCBHDHXPPPPPPPPPPWHFDIJDF
GHACOCHGHBCBBBCBBCBCBHDDIJDD
BHCCCBHDHHHHHHHHHHHHHHDFKLFD
GHGACGHGB[HBBBB]HDDBDDDDBDDD
HHHXHHHDHHHBGYGBHDHHHHHHHPDD
DHCBCBCGDDHCGWDGHDHAAHAAAAAD
DHBCBCBOGGHGAGGBH]HZBHBBBBBB
[HEFF]HHDHHHHHHHHWHPDFDFOPBB
DH`CCC`HGAGHADDDHHHDDFDHHHHH
DHCFCYCHBBBHWDPDDDDDDDDDHD`D
HH`CCCCHGADHFDHDHDHHHHHHB`P`
WHHHHHBHDBAHWDHDHDHDDDDDDDBD
ABBBBBBHDCDHFDHDHDHDADDDBD]`
BAHHHHHHABBHFDHDDDHBRVVSDDBD
ABHWGGAGBZAHWXHHXHHDTQQUBDO`
_BH^AWWGAGWHWZHBBDDDTWWWDDDB
