28 24 4 600
kingdom
7 17 0 12
2 8 20 13
14 1 14 3
4 15 20 13
GGGFFFFFFGGGGFGGGGGGGGGGGGCG
GFGFGGGGGGAWGF]FF\FFFFFFFFAC
`FBFGFFFFFFFGFFFGGGGGGGGGGFG
GFFFGFGGGGGGGGGGGFFFFFGFFGFG
`G`GGFGFFFFFFGGFBFAAMNGGFGFG
FFRVSFGFFGGGFFGFXFBBIJFGFGFG
XFTQUFGFGGYGGGGFBFABIJFGFGFG
ZGGFGFGFGRVSFFGFBFDBIJFGFGFG
GF]FGFGFGTQUFGGFFFFXKLFGFGFG
GFFFGFGFGBFGGGGGGFGBGGGGFGF`
GGGG`FBFFXFBFFBFBFGFFFFFFGFG
GFFFFFFFFFFFFFFFFFGGGGGGGGFG
GFBGGGGGFBGGGGGGFFFFFFFFFFFG
FFFFFFFGFFFFFFFGFGGAGAGGFGGG
GBMNZFFGFBFBFBFGFGRVVVSGFGFB
GFIJ]GGGFGG`GGF`FGTQQQUGFGFF
GFIJBGFFFFFFFGFGFGGGGGGGFGGG
GFIJFGF]GGGGGGFGFGFGFYFGFFFG
GFIJBGFFGFGMNFFGFGFGGCGGGGGG
GFKLFGGGGFGIJ_FGFGFFFFFFFFFG
GFFFFFFFFFGIJGFGFGFGGGGGGGFG
GGGF`GGFXGGKLGFGF^FGFBYBFGFG
BFGGGFGGBFGGGGFGFAFGFXFXFGWG
XFFFFFFFFFFFFFFGGDGGF[[[FGGG
