28 24 0 600
oceans
GGGABGGGCGGCGGHBBBBAGGGGABGC
GMKNDDCRVV\VSCHBMNBHGHHHAGCG
GOLPGBGIQQQQUGHBOPBHGHZHHHHG
BGAGGGCGBGGCGGGBBBBHGHYBAGHC
HHHHHHGBGGABHHHHHGHHGHDGBAHG
G``GHCCGRVSCHAABBGGGDHDGDHHD
DDDDHGCCTQUGBBBBHHHDGFGBGHAG
DBBDHCCCGAGGHHHHHWHGGGGDAHCD
GDDGHCGHHHBBHWGWHGHGDBBGHHGC
DBBDHCCWWHHHHDGGGDGDGGGGHABA
RWVSHGHHHHGGDGGHGDDGDMKWNBGB
IGQJHXGDGGABGGH^HGGDGH[WGGCG
GGGGHHHGBADGDHGGDHDGGOLPHHGG
HGFGXBHGGDGGHGBAGCHGAGGGBHAB
BCHGHHHGGGAHACGCGGAHWGFGGHCG
HGHGH_GGGGHGBGABGCBGHBGFGHBG
GABDHGGGAHADGGCABCGCBHGWGHCC
HBHGGGFGDWBGBAGBGGABGHGFGHBG
BGHHHGGGGHHHHHHHHHHHHHDGDBGG
HCGGGCAGGGGGGCGGGCGGGGGBGDGA
BGFHHGBHHHBABHHHBADHHHDGDGDB
HCAAHBHHAHHBHHAHHBHHAHHGDDDG
BGBBHHHABDHHHBBDHHHBABHHGDBD
HGGGGDGBGGGDGGAGGDGGBGGDGGGG
