28 24 3 600
elected
14 0 3 17
5 7 8 22
14 17 22 7
GBAGGGG``GBGGG]GGGBG``GGGABG
BDAMKHHHHHHHHHHHHHHHHHHKNADB
GGMAZAZAZAZAZAZAZAZAZAZAZNGG
GMHHHHHHHHHHHHHHHHHHHHHHHHNG
GODDDDDDDDDDDDDDDDDDDDDDDDPG
GGODDDDDDDDDDDDDDDDDDDDDDPGG
BGGLDDDDZBEZBWZEBBZBDDDDLGGB
GCBXL]ZBEZWBBZEBZEZWEBGLXBCG
GGGHEBWZBBEZWBBZBBWBZBEEHGGG
BAHZWBZBEZBBFBEBWZEBBWBZWHYB
GMHHHHHHHHHHHHHHHHHHHHHHHHNG
DHABABABABAHDZZDHABABABABAHD
GHBGBBBBBBBHDZZDHBBBBBBBGBHG
DHABBBBBBBBHHHHHHBBBBBBBBAHD
GHBBBMKNBBBFBBYBFBBBMKNBBBHG
DHABBOLPBBBBBBFBBBBBOLPBBAHD
GHBBBBBBBBBBBBBBBBBBBBBBBBHG
GHAGBABABABABA]ABABABABAGAHG
BHHHHHHHHHHHHHHHHHHHHHHHHHHB
AGGAAGGGGGDXDDDDXDGGGGGAAGGA
CCABBAGAGAHWHHHHHHAGAGABBACC
ACRVV\WSBBHBAYBBAHBBRWWVVSCA
BGTQQQQUGAHBBBABBHAGTQQQQUGB
GGGGGABGBEHBABBB^H_BGBAGGGGG
