28 24 3 600
theatre
17 23 2 16
10 21 23 13
23 12 27 7
GGABGAADGAGBBGAGDGAGAGADBADB
ZADAABDABDDAAGDFFCABABAGGADB
ZEDBBBGDGABDBADWFWDACGBABBAD
WMOMOMOMOLMOMOMOFMOMOLMOMOLB
CCCCGDCCCGCGDGA[F[CCCACHBCAC
CGCCMNCGCCCCCGWFFFCGCDCHGGDG
CCCDOPCDCCGCCGFF[FFCCCCHWHBH
CDCCGCCGXCDDGDFYBBFGCXDHHGYG
CCCCCCCCCCCCCBFBBBFCDCDHWGHH
CGCCWCCC````CDFFGBFGCCCCHHHH
CCCCFFFFFFFFFFFBBBFFFFFDDCAD
CCCFBBBBBBBFBBFBFBFBBBBFFCCC
CCF^BXAFBFFBBBBBFBB``DF][FCC
GCF[FBBBBBBBFBFXBBBBBBBGBFCC
CCGFFFFFFFFFFFFFFFFFFFFFFCCC
CCCCCCGCCGCGCCCGGDDDDDDDCCXC
CCGCCCVCXCCCBGCCDCCGCCCGCCCC
RVEVSCDCCCCGCCDGCCCCCACGWCDC
TQQQUWWWWWWWWWWWWWBWWWWWWWWW
CCCWXWGGBGAAGGAGGABABGBGACAW
CXGGBFBGGDBFBBWGGSBOGGACBGBA
CGGGGBFGGR]VBBGGBWBBGABGABNC
GGGGA\IBGTWQJGFGBWABCDAWMGA_
GAAWWVWGGFD`DFWBF]BGG`CAGGPB
