28 24 4 600
baby
2 23 1 20
26 23 23 1
16 1 24 23
27 23 1 23
ADADADAAAAADADADAHBBBGGGHFFG
DADDDDDAAADDDDDA]HBGGBGGHGGG
ADDDADDDADDDADDDDHBBBBGGHGFF
DADABADDDDDABADDAHBGGBGGHGGG
AAADADDDDDDDADDDAHBBBGGGHFFG
D\AADDDADADDDDDADHGGGGGGHGGG
AAAAADDDADDDDDADAHBBBGGGHGFF
DAAAAAAAAAAAAADDDHBGGBGGHGGG
AAAAAAAADDDDDDDDAHBBBBGGHFFG
DAAAAAAADDDDDDDDDHBGGBGGHGGG
AAAAAAAAADDDDDDDAHBBBGGGHGFF
DAAAAAAAAADDDDDDDHGGGGGGHGGG
DDAAAAAAAAADDDDDAHBBBBGGHFFG
GDDAAAAAAAAADDDDDHBGGGGGHGGG
GGDDAAAAAAAAADDDAHBGGGGGHGFF
GGGDDAAAAAAADADDDHBGGGGFHGGG
GGGGDDADADADADADAHBBBBGGHFFG
GGGGGDDADDDADDDADHGGGGFGGGGG
GGGGGAAADAAADGGDAAAAAHHHHGFF
GGGGDAADDAADGGGDAYYYYGGGGGGG
GGGGADAADDAADGGABBBBBBEFFFFG
HHHHHHHHHHHHHHHHHHFFFFFFG_GG
^GFGGGFGGGFGGGFGGGGGGGGGGGGG
FG]GFGGGFGGGFGGGFGGGGGGGGG]]
