28 24 4 600
compute
24 17 12 11
0 22 0 22
2 21 2 4
2 3 16 1
[[[[[[[[[[[[[BBGGGGGGGGGGGGG
HHH[[[[[[HHH[BBGGGGGGGGGGRGG
HHHHVVVVVHBHHHHHGGGGVGMKNTGG
HH]HHHGFGGBFBBGHWHHCH\OLPQGG
HGGFGGGFGFBFGFBBBBBGHHHHHHGG
CGGFGFGGGFBGGFGGGGBBBBBBBBWG
XHHHHHHHHHHHHHHHHHHHHHHHHHHG
GGGGGGGGGGGGGGGGGGGGHFGGGCGG
GVVVVWWWVVVVWVVVVGGGHGGHHHGG
GHHHHHWHHHWWWWWVVGGGHGFH`HGG
GHBBBBBBBHWWWWWVGGGGHGGH`HGG
GHBBBBBBBHHHGWVVGGGGHFGH`HGG
GHBBBBBBBBBBHVVGGGARHGGH`HGG
GHBBBBBBBBBBHVGGGADQAGFH`HGG
GHBBBBBBBBBBHVGGEDDDSDGH`HGG
GHBBBBBBBBBBHVGGDDDDDDGH`HGG
GHHHHHHHHBBBHVGGHHHHHGGH`HGG
GGGGGGGGHCCCHVGHYGGGGHXH]HGG
GGGGGGGGHCCCHGGHSEGGGHHH^HGG
GGGGGGGGHDCCHGGHQEGYGGGFGHGG
HHHHHHWWWVVCHXZHHHHSBFGYGCGG
CC]HGGGGGGVCHXXXXXHGGGCFCHGG
]CCHCCVVVVVGHHHHHHHWHHHHHCGG
_CCHGGGGGGGGGGGGGGGGGGGGGGGG
