28 24 4 600
galaxys
15 23 15 10
27 23 6 10
0 3 13 15
17 10 22 23
ABGDAGGBGGDHBDBDBDBDBDB\GA[[
BDABBHGDGBDHDBDBDBDBDBDBDA[[
DGAGGHGGAGGHBDBDBDBDBDBGGA[[
]GDGDHBAGABHDBDBDBDBDBGGGW[[
HHXHHHGBDBGHHHHDHHHHHHHHHWHH
GGBGBXGGBGGCAAADDBABAHHHHWHH
GGHGDHBHHHHHBBB^BDBDBHYAGDDB
GGDDDHCHGGGHHHHHHHHHHHBDBGDG
GDDDAGGHGDAGDDDAGGGGGHDZAAAA
AA``AAGHGRBBBBBBSXSGGHDGAADB
HHHHHHGHDQGGGGGGQ]TDGHYDBDBG
AAYBGHDHGHHXDGXHHDTGGHADGGGG
BBBDDHGHDBHBDDBHDBTBDHBBBDAB
DBDAGHBHDBHDBBDHBGTGGHDAGAAG
GBGDDHHHGBHHHHHHHHQAGHGDDDBD
HHHBHHAHGBGBBG_GGBGDGHBGBGGB
ABDGGGBHDHHHHHHHHHHDBHDHHHHH
AAGHGGGHGHBBGBBDDBHGDHGGGDGG
BBBHGGBHDHDGGGG`GGGGGHHHHHHD
HHHHBHHHGHBGG`GHDG`GBHGGGDGG
AAABGGDHDHHDHHHHHHHGDHDHHHHH
ABAGDHGHDGBDGDGGDGDGBHGGGDGG
ABBAGHDHHHHHHHHHHHHHHHHHHHHD
BBDBDHGDGBGDGBD]GEDGGCGGDGD]
