28 24 4 600
million
0 23 3 2
15 23 9 19
9 23 9 19
4 23 9 19
BBBBBDBBBBBDBBBDDBBBBBBBWBB^
BHHHHHHHHHHHHHHHHHHHHHHHHHHB
BBBGBDBBBBBDBEBDDBBBBBBBBBHW
HHHHHHHHHHHHHHHHHHHHHHHHHDHE
ZBFBAAAAAAAAADFBBBBBBBBBHDHB
EGBFDDDDDAAAADFBHHHHHHHBHDHB
FBGBFDDDDDDDDDFBHBDDD\HBHDHB
EFBGBFDDDDDDDDFBHBHHHHHBHDHB
BBFBGBFFFFFFFDFBHBBBBBBBHDHB
BBBFBGBGBGEGFGFBHHHHHHHHHDHB
BBBBFBGBGBGBG_GBBBBBBBBBBDHB
BBBBBFFFFFFFFGFFBBBBBBBBBHHB
BBBBBBBBBBBBBBBFFFFFFHHBBBHB
BBBBBBBBBBBBBBBBBBBBBBHHBBBB
BBBBBBBBBBBBBBBBBBBBBBBHHBBB
BBBBBBBBBBBBBBBBBBBBBBBBHHBB
BBBBBBBBBEBBBBBBBBBBBBBBBHHB
BGGGGGGGGGGGGGGGGGBBBBBBBBHH
BGFDDDFGFFFGFDDDFGBBBBBBBBBH
BGFDFDFGFGFGFDFDFGBBBBBBBBBB
BGDFDFDGFFFGDFDFDGBBBBBBBBBB
BGGGGGGGGGGGGGGGGGBBBBBBBBBB
BBBBBBBBBBBBBBBBBBBBBBBBBBBE
]HHH]HHHH]HHHHH]HHHBBBBBBBBB
