28 24 1 600
tocata
7 23 26 23
BBBFBBBFBBBBBBBBBBBFBBBFBBBC
BFBFBFBFBBBBBBBBBBBFBFBFBFBC
BFBFBFBFFCFBBBBBFCFFBFBFBFBC
BFBFBFBFGGFFBBBFFGGFBFBFBFBC
BFBFBFBFGGGFFFDFGGGFBFBFBFBC
BFBFBFBFGGGFDBDFGGGFBFBFBFBC
BFBFBFBFGGGFDFFFGGGFBFBFBFBC
BFBFBFBFGGGFDBDFGGGFBFBFBFBC
BFBFBFBFGGGFFFDFGGGFBFBFBFBC
BFBFBFBFGGGFDBDFGGGFBFBFBFBC
BFBFBFBFGGGFDFFFGGGFBFBFBFBC
BFBFBFBFGGGFDBDFGGGFBFBFBFBC
BFBFBFBFGGGFFFDFGGGFBFBFBFBC
BFBFBFBFGGGFDBDFGGGFBFBFBFBC
BFBFBFBFGGGFDFFFGGGFBFBFBFBC
BFBFBFBFGGGFDBDFGGGFBFBFBFBC
BFBFBFBFGGGFFFDFGGGFBFBFBFBC
BFBFBFBFGGGFDBDFGGGFBFBFBFBC
BFBFBFBFGGGFDFFFGGGFBFBFBFBC
BFBFBFBFGGGFDBDFGGGFBFBFBFBC
BFBFBFBFGGGFFFDFGGGFBFBFBFBC
BFBFBFBFGGGFDBDFGGGFBFBFBFBC
BFBFBFBFGGGFDFFFGGGFBFBFBFBC
_FBBBFB]GGGF^C\FGGGCBFBBBFGC
