28 24 2 600
magical
7 23 27 22
13 23 20 3
AAAAGGGGGGGGGGCGGCGAAAAAAAAA
DWRHGHHHHHGGHHHG\HGCBBBBBBBB
GGTAAAAABBBBAAHGGHCAGAAAAAAA
GGTAZABBBBBBDAHGGHGCGHBBBBBB
GGTAAAABBBBBAAHGGHGHCHGVVVVV
GGTABABBBDBBABHGGHCCCCCCCCCC
GGTABBBBBBABABHGGHHHHCHHHCHH
GGTBBBABABDBBBHGGHGGGGGHAAAA
GGQBBBBBABBAAAHGRHGFFFFHAAAA
GGCBABABBBBBBBHGTHGGGGGHAAAA
SGGRHHHHHHHHHHHGUHFFFFGHAAAA
UGGTGGGFGGGFGGGGTHGGGGGHBAAA
QGGTGFGGGFGGGFGFQHWGWFFHBBAB
GGGQGFHHHHHHHHHHHHGCHHHHHHAH
BHGGGH^GGGGGGGGGGHWHFFFFFGBG
GHHCHHGGCHHHHHCGGHGHFFFFGGCG
GFHGGHGGHCCCCCHGGHGCHHHCGFHG
GGCGGHHGHCHHHCHGGHGGGGGHGGHG
HGHGHGWGCCC_HCHGGHGGGGGHFGHG
HGHGGCHCHCHHCCCHHCGGCHHCGGHG
HGHHHHCWFVCCCCVVFGGGHBBBBBHG
HGHFBCWGFBAAABHCCHGGHZBBBHCG
HGHGHHCGFGBBBGGCCHFGCHHHHCCG
HGGGGCW]FGGGH]HVCHFFGGGGGCWG
