28 24 4 600
confuse
25 23 0 2
27 1 1 6
27 11 18 4
27 8 17 23
FHHHHHHHHHHHHHHHHHHHHHHHHHHH
ZAGBGABAGBAGAGAAGAGBABGGABB]
GBGABAGBEABBABABEBAGAGABBGAE
HHHHHHHHHHHHHHHHHHHHHHHHHCCC
BWBWBWBWGGGGGGGFGGGFGGGFHGBA
\HHHHHHHGHFGHFGGGFGGGFGGCGBA
CGFFFFFHGHGGHHHHHHHHHHGFRGBA
ABGFFFFHGHGFHFGFGGGFGGGRQGBA
AABGFFFHGHGGHGDAGFGGGFRQGGB]
AAABGFFHGHFGHGFBDFFRHHQGGFBA
AAAABGFHGHGGHGGFFGRQGGGFGGBA
AAAAABBH_HGFHGGGGRQEZFGGGFB]
AAAAAABHGHGGHHHHDQHHHHHHHHSA
BBBBBBBHGHFGGGGGGGGGGGGGGGTA
DDDBCFFFGFHHHHHHHHHHHHHHFGTA
FFFGGGFGGGAAAAAAAAAAAAGHGGTA
GGGGFGGGFBBBBBBBBBBBBDEHGFTA
GFBBHHHHHHHHHHHHHHHHFSEHGGTA
GGBGHWWWWBAGGBABABAGETEFFGTA
FGBGHWFDHHABABABBABB^TECGFTA
GGBGHWHDAHBABABBABHHHQGFHHQA
GFB`HWHDBHABBBBBABHGGGGCGGGY
GGBBHWHHWHHHHHHHHHHGFHWHFGBB
FGBXFWWWEWEWEWEWEEWEWGGGG]BB
