28 24 0 600
america
EBGGBGGGBEBVGDHDGVBEBGGAGGBE
AAAMKNGGGBVVGGADGVVBGGRQSGGF
CCCOLPG`GVVGGHDHGGVVG`QTQGGG
GGGGBGGGVVGGHHBHHGGVVGGGBGGG
AGVVVVVVVGGHHBBBHHGGVVVVVVGG
DGVGGGGGGGHHBBEBBHHGGGGGGVGF
GGVGHHHHHHHBBBFBBBHHHHHHGVGD
GGVGHBBBBBBBVVVVBBBBBBBHGVGG
GXVGHHBEBBVWWWWWWVBBEBHHGVGG
GGVGGHHBBZVWVVVVWVBBBHHGGVGF
GGVVGGHHBBVWVVVVVVBBHHGGVVGD
AGGVVGGHHBVWVVVVVVBHHGGVVGGG
DGGGWWGGHHVWWWWWWVHHGGWWGGGG
GGGVVGGHHBVVVVVVWVBHHGGVVGGG
GGVVGGHHBBVVVVVVWVBBHHGGVVGG
AGVGGHHBBBVWVVVVWVZBBHHGGVGG
DGVGHHBEBBVWWWWWWVBBEBHHGVGX
GGVGHBBBBBBBVVVVBBBBBBBHGVGD
GGVGHHHHHHHBBBFBBBHHHHHHGVGG
YGVGGGGGGGHHBBEBBHHGGGGGGVGG
DGGVMKKKNGGWWBBBWWGGRQSVVGGG
BBBGIQQQJGGGHHBHHGGGQQQGVBBB
GGBGIQQQJGGGGHWHGGGGQQQGVBGG
^GBGQLQLQCCCAGGG_CCCQTQ[VBG\
