28 24 3 600
curtain
3 6 27 23
16 6 0 23
16 11 12 10
GGAGGGGGGGDAGGGGGHHGGGGGBGGG
GHHGWWWGGGGWGGADGHHADFFGGBGG
GHHGWBWGHHGBGGWGGHHFGGFGHHBG
GHHGWWWGHHGBGGBGGHHGGGFGHHGG
GHHGGGGGHHHHGGBGGHHGFFFGHHAB
GHHABBBGHHHHGGBGGHHGFGGGHHBG
GHH]GGGAA\HHGGBG]HHGFGFFHHGG
GHHHHHHHDAHHGGHHHHHGFGGGHHBG
GHHHHHHHDDHHGGHHHHHGFFFGHHGB
GGGGGGHHADHHDGHHGGGGGBBGHHGG
HHGHGGHHCAHHGAHHFFFGHHHHHHBG
HGGGHGHHCD_HHHHH]FGGHHHHHHGB
GGHGGGHHHHHHHHHHGFGFHH^GGGGG
FFGFGGHHHHHHHHHHGFGGHHGGFGFG
BGGFGGGGGGGZHHHHGFFGHHGDFDGB
FGGBGHGDGHGDHHHHGBBGHHGGBGDF
FBFFGHBHHHGGHHHHHHHHHHDGFGGF
GGGFGHHHGDGGHHHHHHHHHHGGFGBB
FFGBGGGHGGGDWHHWGDGGGDGGBFFB
VVVVVVVHVVVGWHHWGVVVVVVVVVVV
GBGAGGDGGDGGWHHWGGDGGDGGDGGG
AGABBAGGDGGGWHHWGGBABGGYGGGG
BBBBBBRQQSDGWHHWGDGBGGMKKNGW
GGAGABQUUQGGWHHWGGGBGGOLLPGG
