28 24 2 600
vampire
23 14 11 21
4 14 16 21
DABGGGGGGGGGGVVGGGGGGGGGGBAD
GMKKKKKKKNGGVVVVGGMKKKKKKKNG
GIQQQQQQQJGVVVVVVGIQQQQQQQJG
GIQQQQQQQJGVGVVGVGIQQQQQQQJG
GIQTQLQUQJGVVVVVVGIQTQLQUQJG
GGGGGGGGGGGXGGGGXGGGGGGGGGGG
WVVVVVVVVVGVVVVVVGVVVVVVVVVW
AVVVVVVVVVVVVVVVVVVVVVVVVVVA
DGGVVVVVVVVVVVVVVVVVVVVVVGGD
GGGGGVVVVVVVVVVVVVVVVVVGGGGG
GRSGGGGGGGGVVVVVVGGGGGGGGRSG
GQQGGBGGAGGVVVVVVGGAGGBGGQQG
GGGGHBHB[BGVVVVVVGB[BHBHGGGG
XHHHH`HHHHGVVVVVVGHHHH`HHHHX
B`HH]G^HHGGVVVVVVGGHHZG]HH`B
DDDHHGHHGGGVVVVVVGGGHHGHHDDA
AADDHGHGGWGGVVVVGGWGGHGHDDAD
ADADHGHGWEWGVVVVGWEWGHGHADDD
DAADHGHGGWGGVVVVGGWGGHGHDDAD
DDDDHGHGGGGVVVVVVGGGGHGHDADD
AGADHGHAGGGVVVVVVGGGAHGHDDDD
DAADHBHDGAGGVVVVGGAGDHBHDDAA
ADADHBHDAADVVVVVVDAADHBHDAAA
_DDDHHHDBDDVGVVGVDDBDHHHDDD\
