28 24 4 600
maximum
6 3 25 2
22 12 12 9
24 7 17 8
0 18 10 14
DBDDDDDBGAGHGGGGGGAGGGGGGGG`
DDDDADDDGHGHGHHHHGHGHHHHHHHG
DQQQQQQQGHGHGAHHAGHGHGAGAGHG
DQBGG`]QGHGGGWHHWGHGHDDADDHG
DQXQQQQQGHGHGHHHHGHGHDGDDAHG
GGGGGGGGGHGHGHAHHGHGHADDDDHG
GHGHBHGHGHGHGHAHHGHGHADGADHG
GHGHGHBHDHGH^HAGAGHGHADD]HHG
GHGHBHGHGHGHHHAHHGHGHHHHHHGG
AGGGGGGGGHGHGGDGHGHGDDDDDDDA
WGHGRQSGGHBHGDGDHAHGDRQSDDDW
HGGGQQQGGHHHHHBHHHHBDQQQDDDH
HGRQQQQQSHGGGGGGG`HRQQ]QQSDH
AGQQQLQQQVVVVVVVVVVQQQXQQQGA
WGGGGGGGGAGGGGGAGGGGGGGGGGGH
HBDDDDDDGHHHHHHHXHHDDDDDDDBH
HGMKKKKKNH[GGGGGGZHMKKKKKNGH
HHQQQUQQQVVVVVVVVVVQQQTQQQGH
]GGGBGGFGGDDAFDDFDDGGGGGGYWG
FFFFFFGFGFDDDDDDDBDGMKKKKKNG
BGGFGGGFBFDGFDFDDDHGQQQQQQQG
GFBGGF\FGFHHHHHHHHHGGGFGGGGG
GFFFFFFFGFBGFGBGFGBGFGFGGGFG
_GGBGBGGBFFGBGFGBGFGFGGGGGF[
