28 24 4 600
compose
27 5 0 18
7 16 15 8
11 6 13 16
0 11 17 10
RQSGGGHHHHHHHGHAADDADHGBGGGG
QLQGHGHGHGHGHGGADDADGAGHHHHG
`GGEHGXGXGXGBGHAGADDGHGAHDDB
HHHHHHHHHHHHHGHHHHHHHHGXAGH[
GGGGAGGGGGGGG`HGGGGGGGGHHBHZ
GHHHHHHHHHHHHGHGHHHXHHGHHHH]
GHGDYDYDHBB]HGHGHBADDHGDADHG
GHGGADDGBBBHHGHGHDDDAHGDDDHG
GHWHHHHHHHHHGGHGHADDAH`BHHHG
GGGGGGG`GGGGG`HGHDADAHGAHGGG
HHHHHHHHHHHHHHHGHGDDBHGDHGHH
]AHDWGY`HAHDDDHGHHHHHHGDHGGG
DDHDWGHGHAHDXDHGGGGGGGGDHGH_
HDHDHGHGGDGGGDHHHHHBBDDDGGH\
BDDDDGHDHGHDDDHDDDHHHHHHHWHH
HHHHHHHHHGHHHHHDHDHDDDDDDDDD
GGGGGGG]HEGGGGHBHDHEADADADHW
GMKKKNGHHHHHHHHHHDHHADADADHD
GIQUQJGHABHHDAD`HGGGDDADADHD
DYEX^`GHDDDDDDDDHGHHHHHHHHHD
GMKKKNGHBDHDDDDDHDHBDDADDDDD
GIQTQJGHDBHDXDDAHDHDMKKKNDAD
GGGGGGGHBDHDDDDDHDHDIQLQJAAD
GGBGBGGWDFHDDDDDWDHDDDDDDDDD
