28 24 4 600
colours
0 0 15 5
17 13 1 13
20 14 27 23
18 8 25 12
]G`AGAAAAAAGDAQGYGDABQBGGGGB
QQQSAAAAAADGGBQGQGBDDQARQQQQ
[[[QAAADDAGGGGQGQGQBDQAQ[ZAB
[Q[QAADAGAADGGQGQBQGRQYQQQAQ
[Q[QDDDDDAADXGQGQQQGQDBDQDDB
CQGQWQQSGDDGGGQGDAWBQDADQDAD
GWGCGGCQSGGGGGQQQDQQQQAQQQAQ
BQTQQSGQQQQSGRQCGCGCQDBDQBDD
QQBGBQCQ[CGCGBQGAG]DDDDDQDDD
GGGAGQGQQQQQQUQBRQQQQQUQQQBQ
GQQSDQCGCGGCGGCGQGAGGGGADGGB
GGBQGQQTQQQQQQSBQBRFVFVSGRSG
ADGQGGGAGGGCGGCGQGGGGYGGGBQG
NGGQSGDRQQQTQQQQQ]QGRS_RQQQG
QNBGQBGQGGGGGGGGBXQG]QUQGGCG
QQNGQSBQGRFVFVFGQQQSGCGGCRQQ
ABQGGQQQGQBDDDD`BQQQQQQBQQB\
YGQNB[QQGQDDQQQQXQBBB`QQQ[BA
BDGQN[EQDAGDQG`GBQXQSGQXBBGA
DNGGQQQQGRQQQQQQQQGQQGDWSGGW
DANGGBBGGQAQGG`BQQGWQQQQQSGW
BDQNGGDDRQAQGGRAQXWGG`G`QQSG
AGBANGGGQDDWGBXDGGQQSGGG`GWG
DGDB[NBGWDDQQQQQSGX^QQQQQQQG
