28 24 2 600
happens
18 6 15 6
19 13 8 16
GGGGGGGGGGGGGGGGGGHBDABBBDBG
GVVVVVVVVVVVVVVVVGHABBGAGAHB
GVZZDDDDDBBBBBBBVGHBADABBBHG
GVDZDDADDB[BB[BBVGHADBBBABHB
GVYZDF^FDB[BB[BBVGHBBAGABGHB
GVZZDFFFDB[BB[BBVGHDADBBGDHG
GWDDDDDDDB[BB[BGVG]BBBDBAGHB
HHHHHHHHHHHHHHHHHHHHHHHHHHHB
CBVCCGGRKSGGWGGBGHGGBHGGWGHG
CFVCVGBILJGHGGHGGGGHGGGGGHHB
CCVCVBGOQPBGBGGBGHGWRKSHBGHG
FCVCVGGOQPGBGHGHGYGGILJWHGHB
CCVCVBGBGGHGHGBGGHGBOQPGGBHB
CCCCVGGHGBGBAWGHGGW]OQPHGBGG
CTVVVUFHHHHHHHHHHHHHHHHHHHHH
DDDDDDFD`G`HGGYGGAGDGGGDGACA
DFFFFFFDGDDHGRKSGHGBGHGBGHBB
DFCEFCWD`G`HGILJGGGGMQNDFHAB
DDDDDDHHHHHHGOQPDWDGGGDGGHBB
FFFDHHHGGABHGOQPGGGHGWGGGAGG
DDDDHBGGHBGHGGGDGDGGGGHHHHHH
DFFHHGGMQNGBGFFGGBGMNGHDBGX\
DFDBGGMYWQNGFAAFGGMQQNDGXCX_
DDDDGGGGGQQNGBBGGDGGDGGWXGCG
