28 24 4 600
persons
14 11 12 23
12 13 0 0
12 11 26 23
14 13 14 7
GBBBBBBBBBBBBHGBBGBGBBGG_GBG
BBFFFFFFFBBBBHGHHHHHGBGGBGGB
FBFBBBBBFBFFBHBHGGBHHHHHHHHH
BBFBBFBBBBBFBHBHBGGBGBBBBGBG
FBFBFFFBBBBFBHGHGHHHHHHHHHHB
BFBBBFBFFBBFBHBBGHBGBBGBGHGB
BBBFBFBBBFFFBHGHHHGHHHHHGHBG
BBFFBFBZBBBFBHBBGBGHGBGHBHGB
BBBBFBBBBBFBBHHHHHHHGBGGBGBG
BFBBFFFFFBBBBHGGGHBGBHHHHHGG
BBFBBBFBBBFBBHGBGHGBGHBGBWGB
BBBBBBFBFBBB][]FGGBGBHGBBWB\
HHHHHHHHHHHH[[[HHHHHHHHHHHHH
FDDDDFDFDDFD][]``GBGDGBGBBB[
^FDFDYDDFDDDDHGBBBGDBGDGB[B[
DDFADDCCDDFDFH`BGDBDGDBDB[B[
FDDDDDFDDDYDDH`ADAAGAADGB[B[
DDRKSDDDFDDDFH`ADDDDDDDDB[B[
DFILJFDFDDFDDHDADDDDDDDDB[B[
DDOQPCDDCRKSDHADDDDDDDDDB[B[
FDOQPDDFDILJDHDDDDXDXDDDB[B[
DCDDFDCDDOQPDHDDXDDDDDXDB[B[
YDFDDDYDCOQPDHDDDDDXDDDDB[B[
DDDDFDCDDDDDGHDDDDDDDDDDBFGF
