28 24 4 600
conquer
22 23 11 23
6 11 13 23
3 3 6 10
13 11 9 11
GD`HEGGBHGEGGGGHBGGGGDBGHGAG
DE`HGGHHHHGBGHEHGHHHHHGEHGHG
GGHHHGGBGXBHGHHHDBGGGGGGGGAG
GBH]HGHHHHGHDGBGDHHXHHHHHBHG
BGHCHGHA^HDHHHHHGHBGGGGGGDGG
GEBXGBHABHGBGBDEGHHHHHHHHXHG
BHHHCDXBEHEGHHHHBGDGEGGDGGHG
TVVVVVVVVVVVVVVVVVVVVVVVVVUW
CCCCCVE[EDDDVABEEDAEEEDAGBGA
CFFFCVEEEGXDVDGAAGBDAAGBDAAA
CFYCCV`GCDYGVGEDDDABAEEDBEDD
CFBB\V]ECGDGV]AGDGBGABAADEGB
XTAVVVVVVVVVVVVVUGDABDADGAAD
BBBBEEEVAGDGABGBGDBAGABADEBD
BFFFFFFVDBADDGDDBADEDAGDADAA
BBBBBBBVBDDBGADEEBDBBDEDEBDA
FFFFFFBVGDABBBDBDDDGDAGGGGAA
BBBBBBBVE`AGBGBD`BDABDEGXGDA
BFFFFFFVADABGADEBMNDEDGGGGGE
BBBBBBBVDBBGDAD`MGBNGBGGGGGG
FFFFFFBVBGEBBDDMBAGYNGGGGGGE
DGBBBBBVBADGDGMBBBBDFNGGGGGG
DGTAVVVVVVVUZMYBFBBFAFNGFBF_
EDGCGDG`BGBGMGDBBBDBDG]ND`GG
