28 24 2 600
evening
12 23 14 21
1 14 3 5
BBBBBBBBBBBH`GGGDGGDGGG\GGG`
BHHHHHHHHHBHGDGTVVVVUEGGGMNG
BBBHBBBBBBBHGEGGGGCGGDDGGGXG
HBHHHHBHHBHHDGMNGGTUGGGGYGGG
BBHBBBBBHB_HGGGXGGGGDGGTVVVU
BHHBBBHBBBBH`YGGDDGGGGDGGGGG
BBHHHHHHHHBHHHTVVVVUGGGGDGMN
BBHBBBHBBHBBBHDGDGGGGGXMNGGG
HBBBBBHBBBBBBH`GGGDGYGGGGDGB
BBHHHHHHBHBHHHHHHHHHHHHHHHBX
BBHBBBBBBBBBBBBBBBBBBBBBBHBB
HBHBHHBHHBHHHHHHHHHHHHHHBHYB
BBHBBHBBHBBHBBBBBBBBBBBBBHWB
BHHBHHBBBBBBBHHHHHHHHHHHHHXF
B]HBBHBBHHHBHH[[[FBBBFBBBBBB
HHHHHHHBHBBBBH[[^XBFBFXBFFFB
BBHBBHBBHBHHBHHHHHBFBBBBFBBB
BHHBBHHBHBHBBBBBEHBFFFFFFBFB
BBHBBBBBHBHHHHHHHHBBBBBBBBFB
BHHHHHHBHBBBBBBBBHFFFFFFFFFB
BBBBBBBBHBHBBHHHHHBBBBBBBBBB
BHHHHHHHHHHHHHGGGGBFWFFFFFFB
BBBHBBBBHBBBBHGFFFFXZBBBFBBB
BHBBBBHBBBHB]H````FEFBABBBFB
