28 24 4 600
masters
25 19 9 14
0 9 27 19
0 7 0 23
3 21 0 7
BBBBBBBXBGGG```G^[[HBBBBBBBB
BBBBBBBHHHHHHHHHHHHHBBBBBBBB
BBBGGBBXBBBBBYHBBBYXYGGBBBBB
BBBB`BRKSBBBBBHBBBBRKSGMNBBB
BBBGGBILJBBBBBHBBBBILJGGABBB
BBBBBBOQPBBBBBXBBBBOQP\MNBBB
BBBBBBOQPHHHHHHHHHHOQPHHHHHH
]AAAAAAAAAAAAAAAAAAAAAAAAAWW
FFAFAFAFAFAFAFAFAFAFAFAFAFFF
]GBGBGBGBGBGBGBGBGBGBGBGBGBG
VGVGVGVGVGVGVGVGVGVGVGVGVGVG
VVVVVVVVVVVVVVVVVVVVVVVVVVVG
GGGAGGGGAGCGCCCADGDADGAGDGGD
GXGXGXGDWGFFGFDBGACBGCBAGBAB
GGGGGGGGFCGCFFBAFBDDABFBCFAD
XFFFFFFFMWNGGFFFFFABBDDABDBD
CBCCBCBMQGQNCGAFBFBDACBBADBF
ACABCAMCGCGCNBBABFGBBGFBBDDB
BBBBAMQCQQCQQNFFAFFFFFFFFFFF
BABBMQC`WQCCCWNBADCGCCCCG]ZG
BBAMWQCQQQQQ`CDNFGFFFFFFFFFF
BAM]CQCCCQ`CCCGCNCGCGCCGCGGC
BMQQGYQQ`QC[CCCCCNFFFFFFFFFG
GWCCGWCCCQCGCWC[CQN_GCGCCGGC
