28 24 4 600
pimples
0 8 0 23
22 1 13 21
6 12 10 23
21 13 26 16
AGFAYBHFFCFGCGFGBGGBGAGGAGGG
FBDABMQNCGGCGBCGXHFCBF]FHHHG
BABBMQQANGXHHHHHHHGCGBDGB[HG
ABBMABBBBNGCHABABHHCGGGGB[HG
BGMBBBBBQANGCFDMDHGGGGHHHHHG
BMQWQQQQQCQNGH`HGHGGHHHDCGDG
BGGGGFCGBCFCGHGHDHGGH^HBFDGG
FGGCGGGBGCGGCFBH`HAGHGHHHHDG
]WGGBHHHHHHHGGGFGHWGHC`GBHGC
GHBAFHBC``HDDXGBDHGCHBGF`HGF
WHHHHHGGF`HGGGGXBHCCHFCGCHGG
GAABHFCFAFHGGGGGBHCGHXBFG`FG
AAABHF]BBHHHHHHHHHXXHHHHBGGG
BBAZHBGBGBGGADBGBAAAH]FHFGCG
GHHHHHHHHHHCFGGBGBBBHB[HBGFB
BHAAHABBABAGHBRKSGAGHGBHYWFW
BHABHABBABBHHGILJBBBHBBCCAGE
GHABHBBBBGA_HBOQPAGAH[BHHHHX
BGFGHHHHHHHHHGOQPAABHBBBBGH\
GBGBHABEAGYBHBGBGBBGHBRKSBHH
BHHBHAGBEEAEHHHHHHHHHGILJBHG
BH[GHEBABABEHGYBB[BBBBOQPBHG
CHBGHBAEEAEAHBBBBBBGBBOQPBHG
GWGGGAEBGAGBHBGBFBF[BBGBB[H[
