28 24 3 600
thrust
15 18 11 7
12 18 12 21
25 21 22 15
GBGGBABBGAGAGGGAGGAGAGGAGGCG
GEAAGBGABBAABABBABBBABABBAXA
GGFFFFFFFFFFFFFFFFFFFFFFFFGC
BGFWWWWWWWWWWWWWWWWWWWWWWFAC
GBFWFFFFFFFFFFFFFFFFFWFFWFCG
DBFWFDDDDDDDDDDDDDDDFWWWWFGA
GYFWFDBBBDBBBDBBBDDDFWFFWFGW
BWFWFDDBDDBGBDDBDDDDFWWWWFAC
GGFWFDDBDDBDBDDBDDDDFWFFWFAC
BGFWFDDDDDDDDDDDDDDDFWWWWFCG
GGFWFDAAAAAAAAEDDDDDFWFFWFAG
GBFWFDA\AAAAAAEXDDDDFWWWWFCA
GGFWFDAAAAAAAAEDDDDDFWWWWFGC
BGFWFDDDDDDDDDDDD`DDFWWWWFGA
GGFWFFFFFFFFFFFFFFFFFWWWWFAW
GBFWWWWWWWWWWWWWWWWWWWGBWFAG
GGFWWWWWWWWWWWWWWWWWWWWWWFCA
BGFFBFFFFFFFFFFFFFFFFFFBFFGC
GGGGBXBBZBBB]BB]BBB_BBBBGDGD
EFFFFFFFFFFFFFFFFFFFFFFFFFFE
CFWWWWWWWDDVVVDDDAWAWAWAWAFB
`FCDCYCDCDDDGDDDDWAWAWAWA]FG
`FD^DEDEDDDDDBDBDBDBDBDBDDFB
BFFFFFFFFFFFFFFFFFFFFFFFFFFD
