28 24 0 600
colonel
DDDDDDDDDDBDDDDDDBDDBDDDDDBD
BMKKNHHHHDDADBDDDADDDABDDDAD
XWEWJABBHDRVSDDBDBRSDBDDBDDD
HQUPUBABHDUQUDDYDDUUDDDDDDBD
ABBABBBBHDDDBDRSDDDBDDRVSDDD
BBABBBBAHDBDDDTTDDDDYDTHTDAB
BABBBABBHDDDDDDDDBDDDDDDDDDD
ABABABBBPPPPPPPPPPPPPPXPPPPP
BBBBBABBBGBDAGYDACGHBHBFGGGA
BABBBBBBBBGGVGVGFDAHGHBXGDBB
OOOOOOOBHHHGVGVGFGBHGHGFAGGG
GAGBBGGCGCHCVBV`FGFHDHGFBDAG
ABAIJGCBAGHGVBVGFAGHGHGFGGBD
BBRKKSB[BCHGVBVBFCGHDHBFAGDA
GAQ`DQB[BGHCV^VBMNGHGHGFADGB
DBHD`HGBGGHGWVVFPWCHGHDFBGBD
BCPWWPCGGCHGGCGGCGGHDHGFGADA
GGCBCGGAGGHVVVVVVVVVGHGFABGD
GCGCGBRVSDHAAABABABFYBGFDGBA
FMNAGGTWUGHBAFBABB\FCGCFGAGB
ATUWBGCGHCHDBFFFFFFFGCBFCBDG
BBMNGGGCHBHGDGGGGAGGGGGFAGAG
BAWTBMNGHHHDGMKNDRVSBGCFDBBA
GAGWCPPGC_GCGUUUGWWWABFFBDZB
