28 24 3 600
persons
20 12 20 14
22 21 27 12
11 4 1 20
GGGGGGGGGGGGGGGGGGGGAGGGGGGG
ADAWFFFFFFFFFFFFFFFFFDDFFFFG
FDFFFDDDDFBGGFWFGGBGGGGBF[FG
DDDDFDFFDFGGAGGGYGGFFFFFFGFG
HHFDFDFBDFF]BFGFBFFFDDDDFGFG
DDDDFDXYDBDFFFBFFFDBDFFAFGFG
DFHHFFFFFAAAAFFFAAAADDDDGGFG
DDDDFDDDDWAAAAAAAAAFHDHDHGFG
HHFDFDFFFFFAAAAAAAFFDDHDHGFG
DDDDFDFZF[[FAAAAAFFDDFHDHGFG
DFHHFDFDF[[[FAAAFFDDFDDDGGGG
DDDDFBFDFFFFFFAFFDDFFFDFFFFF
HHFDFDFDDDDDEAAFWDFF]DDF`DAG
DDADFGFFFFFFFFAFFDWFFFFFBDDD
FDFDF`^FFBFDDBABDDFFGADDDDDD
HDHHFFFFG`FDMNAMNDFFDDDDDDDD
GDGGFBFGGFFDLLAPPDFFFDDMKNDD
GXDGFGFGFFDDDBABDDDFFDDOXPDD
GHHGFGFGFFDMKNARVSDFFDDDDDDD
GHHGFGFGFFDUHTAUQTDFFFDDDBDD
GGHGFGFGFDDDDBABDDDDFFWWDDDD
YDHGGGBGFDRVVSAMKKNDFF]WDDDB
FDH[[FFBFDTQQUATTTTDFFFWWDDD
_DH[[FGGGGGGGGAGGGGGG[F\WGBG
