28 24 4 600
intense
12 1 19 0
6 2 6 0
8 2 8 0
20 15 21 11
AAAV\GG``GGHBH_DDDWGWBDDYGBW
BBBBVVVVVWAB]ACDADOAPDXBVGBB
BBBBBB]B]VAHXBRDSCCBCCCCCBDW
BABBABBBBBBHHHHDAHHHHHCBCABB
YBBBWBBABBVFWCBDFBBCHCCFBCDA
BBABBBBBBABFCWCHBBBBHCAFCDBB
BBBBBABBBBBFBCWDBBBBCCMNWFBB
BABABBBABAAFAADDDBBCXHPPB[ZB
BBABBBBAAABFDDADDACACCBFGBGG
BWBBBWBBBBBFBBDADBACCBFGGGGG
VVVVVVVBBBBFBWBADBAACFBBBBBB
ABBBBBVVVVBFBZDACBWCFGAFFBWD
BBHBXBBBBB^FBWBDCBAFGBFBF[BD
CKKKKKKKKKKKFBCCDB[WGBBBFBWD
BBBBBBBBBGGGPPPPPPZWTUTUTDDD
FWAWWAWWBV`VCCDDCCFW]CYAWDWB
BADFCCCWBBVCDADACDCFCCABQDB[
DAWDCACW[VCCCCXCCCB`FCBQQDWB
FDDBCCWWVCCGAADAADBGGFCDDDDD
DWDDCCDVAXCGWDDDDCBGG`FFDAFD
YDCXDVDCDCGGGGGGBB`GGWACDFHB
WDDCCAVVWFFFGGFFFFF`HWHDHHDX
DBCWDDDDFADDFFGG`GGFAFCDDHDA
WCCCWWBBCDCCCGGGFGGBCCBCCCBF
