28 24 1 600
heaters
0 0 0 13
]BGAGBGGGBGBGGBGGBGGGBFEFGCG
PGGPBGGAGGGGBGBGBGGBGGFEFGOG
QGBQGGBOGBBABGGBABGGBGFAFCQC
QGGQGBGQBGGBABGBGBBGGGGYGGQG
QBGQGAGQGGBGBBGBBGGFGGMKNGQG
^MKKNCBGGBGBAUABGBGGFGILJCQG
GIWHJGGGGGBGR[SGGBGCGGO`GGGC
CGGGCGMNGGGRCBCSGGGOGGQGCGCG
HWHHNGWWGGRCBCBCSGCQCGQGGAGG
GGGBHGGGGRCBCCCBCSGGGGQG_WGG
AGNFHGGGRCBACCCABCSGCGBGGGFE
WBHGGGGRCBCCCCCCCBCSGGHHHHHH
BGHGBGRCBACCCCCCCABCSGCH[ACB
GHHGGRCBCCCCC\CCCCCBCSGGHNBB
HHBGRCBACCYCCCCCYCCABCSGGCCC
DDGRCBCCCCCCCCCCCCCCCBCSGGCG
GGRCBACCCCCCCCCCCCCCCABCSGCG
CRTTTTTTTTTTTDTTTTTTTTTTTSGG
GGGCGGCGGCGGCGGGCGGCGCGGGCGG
WWWWWWWWWWWWWWWWWWWWWWWWWWWX
AGBGDACAGBBGDBDAGDABGAGBDBAB
BAABCBABDBABGAGBADBGBDACAGAB
DADBAGBAGGDDACBGBGCAGBADABDC
ZBGGBADCBABGBCBADCABBACBDBAB
