28 24 1 600
hillock
14 5 9 20
GCGGCGGGGCGCGGGBAAAHCDCDDBB_
CGCGFFFCGGEGCGUGBAAHDEHHHHHH
GGCGF`FPGEEEGR[SGBAHDCDBBDDD
GFGCGGGQGGEGRTTTSGBHHHHHHHED
CCGCGC^QGGGWBGGBGGBHCDBBCDDD
WHHHHHHHHHHHNG]GBGGHCEHHHHHH
GAXBHGBGBOBGHGBGGBGHDDDBBDCD
BBNGHGGGGQGGHHHHNXMHHHHHHHED
DGJGGGGUGGBGOGGDGCGGGAGGCGGA
GGJGBGR[SGGGQDPGGDGDGUGDGMNA
GAJGGRTTTSGGQGQGBGGGR[SGGIJD
BBJGGGCGGAAAQDQGDGDR[[[SGGDG
GGHKKNGCGCCCGGQGGGRTTTTTSGGG
GCGCGJGGCGMKKKNGGAAAAAAGGCGD
GGCYGHKNGGXAGBJBBBBBBBBBMKKK
BMGWGCZJGGMCPGJCGC`D`CCGIDGG
HHHHHHHHKKHGQGHKKKKKKKKKHGOD
BABBBABABFGGQEGGAGGGYGZGGZQG
BBBABBBABGEGQGGEEEGEUGGBGGQD
ABBABABBBUGGGGEGEGGR[SGZZGQG
BABBBBBBRGSGEGGEGGRTTTSGGBQD
BBBABBARDDDSGGEGGYGGGBGZGGQG
ABAABBRDDDDDSEGEGPGZGGGBGZQG
BBBBBRDDD[DDDSGGEQGGAGGZGBQ\
