28 24 3 600
pilfers
14 3 6 14
8 8 5 19
25 12 11 13
WWWFWWWWWWWWWFWWWWWWWWFWWWWW
WGCGGCGGGUGGCGGAGGCGGGGGGGBW
WBGBGFGGRTSGFGGDGGGFGRSGGFGF
WG_FGGGRTTTSGG]GGBBGRB[SGGGW
WGFGCCGBGGGBGCGGGYGRTBFTSGFW
BFFFFFFFFG\GFBBGGVGGGGGGGGGW
BBBBBBAFGFGGGAGGRTSGFGBFBGCW
BBABABBFGGFGGDGFBGGGGGGGGFGF
BBBBEBBF]GGGFBGGGGBFBGAGPGGW
BBBABABFFFFFFFFFFGGBFGWGQGGW
ABBBBBBFDGDGGDGDDOGGGGFGQGPE
FFFFFFFFGDGDADAXGQGOGCPFQCQX
CCGACGCDGDMKKKKNFQCQAWQGQ]QB
GGGOGDGGDGIGAG[JDBFQFCQGDOGG
GBAQGGGYGDILBLHJGFGGGOGGGQGB
AGCQGDFFFGDGDGFGCGCBGQGCBQGF
CGGQGGDDGDDGDGPBGPGGGCBGFGCG
BAGQGAGGGGGBGGQGCQGPGGPGCGBG
GCGGFFFBPGDGDGQGGGGQGCQGGOGC
CGGCGGFGQGGGGGQGCOGGGBGFGQBG
FFFFFB`CQGXGDBGOGQGOGGPGGQFG
CBCG`CFBQGGDGGGQGBGQCBQGCGCG
CFFFFFFGQGXGDDGCFCGQGFGGAADP
G`BDC`^FBGGGGGBBXBBQ`CGBFZFQ
