28 24 2 600
mediate
15 23 22 5
13 0 26 23
DAGDBHBBDDGGD]D``DD^BHGBABGG
BMKNGGHBBBBBBCBBBBBBHGGGAGGG
DILJGDBHGGGGMKNGGGBHGGGBABGC
WBDGGGGGHBGGIWJGGBHDDXDFHFCG
FGGGDHDBDHBGGBGGXHBDGGBHBHGB
GMKNGBHGADHBGHGBHGGGHBGHBHGG
GILJGGGHBGBHGBGHBGBHWHHHAHBC
BGGDGDGGHDDDHBHGGGHGDGDGBHHG
DMNGFFFGBHDGGBGGDHWDBBGYGGHG
GIJBFGDGHGHBABABHGHGDGMKNDHC
GBWFFGBHG[GHFDFHG[GHGBIWJGHG
GMNGGDHG[Y[GHBHG[B[GHGGDGDHG
DIJBDHZZZZZZZOZZZZZZZHGGHBHB
FBGGHGDGCGBGDQDGDGDGBGHDGHHG
GGDHGBGGUGDBGQGMKKKKNGBHGDBG
DBHCGDGR[SBGDQDICCYGJDGGHGDD
DGGGBGRCBTSDGQGIGHHGJGBDGDBG
GDBDGRTCTCCBGQDICHBGJDGGBBAC
BGDGRBCCCCTTSQGCCHHHJGBGDCBC
FFFFFFFFFFFFFFFFFFFFFFFFFFFF
ACBGCACBDGBAGCAGWXXGBGBGGBGB
BGABBCGAGACCACBCHHGAGGDGBBBG
_CBCABACCBGABGCAHBBBBDGBBBDY
GAG\CGBGGAGCGAB]HGC``BBGBFGB
