28 24 4 600
compact
9 10 27 0
16 23 13 15
8 10 25 16
27 6 20 10
AAAAXGCGCGEAGGBBGABABBABGACG
BAAAHHHHHHHHHGCGABCCACBACABC
GBAAABCGCZHAHCGBCGABBABCGCAB
CGBABGWWWWWWHBABABBBBBCACGAB
GGGBGCGCGCHWH`CCBACACAGCACCC
WWWWWWWWWGHWHHHHCCBCBBAGBBAB
CCCGGCGCGGHWH[[HBACBABCBACB]
GGWWWWWWWWHWHBBHHHHHHHHHHHHH
BGCCCCCCGCGCGGCGBH^ACACBG`CB
XHHHHHHHHHHHHXHHHHBCBABCAGOG
BGBFGGBV]]FGDYH[ZHGAGAGABCQB
BGFFGGR[SGGGGDHAAHCBBBCBBBQC
GGGGGR[[[SGGFGHAAHGACABACAQG
FGFFRWWWWWSGFGHAAHABBBCCBCQC
YGGGFGGFGGFGGGHAAHBBGAAGAAQG
WGFGGGG``GGGGGHAAHCACBACABQC
HHHHHHHHHHHHHHHAHHGBGBCBBGQG
DGG[B[GGDGDGGGGBDHHHHHHHHHHX
G[GDGGDDDGGGDGFGGHZ`G`GGGGYE
GD[[F[FGGFFFGGGFDHGGGGGAGGCG
DG[B[GGDG`F`GGDFGHBGYGBBBGGF
GGGGG[[GGFFFDGGFDHGGCG\GGGGG
G[G[GBBDGGGGGGGFGHBGXGGGBGXG
_G[GDG[GXXGDGDGF]HGGGDGGGGGG
