28 24 0 600
cartoon
GGGAGGAAAAAAAWGFWWWFWWBBGAGA
CBBWGGWDAXWBWFWBWFWEBBBBBWGW
CYBCGGBBBBBGDGDGDGGDGGAGGGGA
BFCGGAGCAGGGBACCCCACMKKKNGBB
DHGGFHHHHGBGGBCGGCBCI^[[JGGB
DHGGOXABHGAGGACGACCWIAAAJGGA
DHGWQAMBHGDGDACDADADIDDBJGGW
DHHHQAIBHGGGGCGGBGWGIBDAJGFB
DH[BGCICHGGAGAAGGCWGOGABPGGA
DHHHGGGGHGXWGCCGXAGDQDZXQGDB
DGXHGBHHHGGGGACDAWGGQBBBQGDB
DGHHGBHCAGAGGDGGDDGBQDGDQGGB
FGGHHBHXCGWCGWWGGAGDQABAQFGF
FFGBBBHHHHHHHHHHMKNGQBABQDGW
[OGGGGDGBGDGAGGH_YJBQADAQGGB
GQAGWGGMKNDMKNGWGBH\QDDWQGF[
GQWGMNGILJDIGGGWGGHHQGAGQBP[
CQHGIJGGGDDDGAGGGGGGGDDGQGQ[
GGHGDGGBBMKKKKKNAFMKNGXGQBQ[
G`HGFGFGGIHLHHLJAIWEJGGGQGQ[
C`HWGGW````WGGGGDGGGGGGGQBQF
G`HHHHHHHHHHHHHHHHHHHWGGQDYW
G`BCGGDGGBCGFDGGBBBHHHHHHGFW
CGBFGDCWGGBBGGBGFCGGGDGDGGWW
