28 24 0 600
tubular
WWWFWWFFFFWWWWFWWWWFWWFWFWFW
WFWFWFXWFWWFFFWWFFFFWFFWWWFW
WFWFWWWWWWWFWFWFWWWWWWFWFWFW
WFWFFFWFFFFFWFWFWFFFWFFFFWFW
WFWFWWWWWWWXWFWWWWWFWWWWWWWW
WFWFWFFFFFWFFFFFFWFFFFFFFFFF
WFWXWWFWWFWWFWFWWWWWFWWWFWWW
WFWFFFFWFFFWWWWWWFWWFWFWFWFW
WFWWWWWWWWWWFFFFFFFFFWFWWWFW
WFWFWFFFFFFWFWWWWWWWWWFFWFFF
WFWFWFWWWFWWFFFWFFWWFXWXWWWF
WFWFWWWFWWWWFWFWWFFFFFFWFWWW
WFWFWFFFFFFFFWFWWFWWFWWWFWFW
WWWFWWWWFWWWWWFFWFWWWWFFFWFF
FFFFWFFWWWFWFWWWWFWFFWWWWWWW
WWFFWWFFFFFWFWFWWFWWFWFFFFWF
WWFWWWWWWWFWFWFFWWWWFWFWWFWW
WFFXFFFFWWFWFWWFWFFFFWFWFFWW
WWWWWWWFWFFWWWFFWWWFXWWWFWWF
WFFFWWFFWFWWFWWWWFWFFFFWFFWF
WWFWFWWFWFWFFFFFFFWWFWFWFWWW
FFFWFFFFWWWWXF``````DDFWWFFW
FWWWWWWFFFFWFFFF`FFFWDD_WFWW
\WFFFFWWWWWWFWWW`FWWWDFZWF^F
