28 24 2 600
pirates
12 11 22 17
0 16 18 22
GBGGGGG[G[G[[[GG[GG[GG[GGGG`
`BGGGGGG[GG[G[GG[GG[GG[GEEEG
GBBBBGGG[GG[[[GGGGGGGGGGGGGG
XGGGGGGGGGGGGGGG[GG[GG[GGGGG
GGGGAGBBBBBBBBBBBBBBBBBBGGHG
GGGADBDDDDDDDDDDDDDDDDDDBGHG
GGADGBDDDDFFFFFFDDDDDDDDBGHG
GGDGGBDDDFFAAA[FFDDDDDDDBGGG
GSGGGBDDFFBBGGGGFDCEDEDDBGGG
GGGGGBDDFBBBBBBGFDDDEDDDBGFG
JGGGGBDDFFFBBBZFFDCEDEDDBGFF
GGRGGBDDDDF_]BFFDDDDDDDDBGGF
QGGGGBDDDDDFFFFDDDYDDDDDBGFF
GGGGGBDDDDDDDDDDDDDYDDDDBGFG
GVVVGBDDDDDDDDDDDDDDDDDDBGFF
GVAVGBDDBBBBBBBBBBBBBBDDBGGF
]VDVGBBBGGGGGGGGGGGGGGBBBGGF
BVBVGBGGYBGGGGGGGGGGBYGGBGGG
GVGVGGBBBBGGGBBGGGGGBBBBGGGG
GGGVWWWWWWWWWWBWWWWWWWWGGGGG
GMNWWFWWFWWFFWWFWFWWFWXGGTUG
GOPWFWWFVFWFVFWFWFFWFWXGGGGG
GGGWFWWFFFWFFWWFWFGFFWWGGGGG
`GGWWFWFVFWFWWWFWF^\FWXGGGG`
