28 24 3 600
galleon
27 12 13 22
26 5 10 14
12 10 26 14
QWWWWWWWWWGGGGGGGIIIIIIIII[[
FFFFFFFDDFBFFVFGGYGGGGGGGG[[
F^GFFFFDDFDFFFFGFFFGGFFFFFFF
FGGFGGGDDFDFFGGGFGFGGFZGGG_F
FGGFGGFFFFDFGGFFFGFGGFGGGFFF
FGFFAYFGGYGFFGFGGGFGGFFGGF]B
FGFGAFFGGHGFFGFGMNFYGGFGGFFB
FGFFAGGGGHGFGGFGOPFFGGFGGFFB
FGGGCGFFGTUFFGFGGFFFGGFGGFGB
FFGGFF\FGHGFAGFGGFGGGFFGFFFF
FFFFFBBFGHGF]BFGGFGFFGGGGGGF
XXXXXXFFGHGFFGFGGFGFFFFGFFFF
BFFFFFFGGGGFGGFGGFGGGFFGFGA]
BEBFFGGGGFFFGGFGGFFGGZFGFGWF
BBBFGGGGFFGFGGFGHGFZGZFGFGGF
BBFFGGFFGGGFGGFGGGFGFFF`FGGF
XXFBGRGGGFFFFGFFFGFGF``GFGGF
FGFBGFGGFFGGGGGGFGFGF`JGFGGF
KGFBGFGGFFFFGFFGFGFGF`JGFGGF
KGFBGFGGGGGFGEFGFGFGF`JGFGGF
KGFBGFFFFGGFFFFGFGFGF`JGFGGF
KGFSGGGGFFGGGFGGFGFGF`GGFGGF
KGFFFFGGGGFGGGGGFAFFFFFGFGZF
GGGAGGGFFEBFFFFGGDGGGGGEFBFF
