28 24 4 600
buried
21 13 13 11
25 16 20 14
25 17 21 11
27 2 11 23
DDDFDDDFDDDFCFCFCCCFCCCFCCCF
DFDFDFDFDFDFCFCFCFCCCFCFCFCF
DFDFDFDFDFDCCCCFCFCFCFCFCFC]
DFDDDFDDDFMNFFCCCFCFCFCCCF`B
_HTUTUTUTUOPHHHHHHHHHHHHHHHH
GFFGXHFDBDSDDDDDH`GGBLGYGYYY
GFGGGGHDDDRDDDDDHGGBGLDBCBDB
GFGFHDDDDDDDDDADHGBGGLGAGAGG
GFGGHADDXDDBBBBBFBGGGLLLLHGG
GFFGHDADGGGGGGGGGGGGGFBBBGGG
GFGGHDDAGGGGIIIBADABLFBGBFBF
GFGHHDDDAGGGIGIIADABLGFGFBBF
GGGHZCCCDGGGI\IGABAGLBF`FBFB
GRRRRRFFFWFFFFFFFFFFF]FAFBBB
GAAABSBBGABABABGGABBGFFAFFBF
BBBBAS^ABBABBABABAHWHGGDGFBF
AGBBKKHHHHBABBABABHDDHHGH]BB
ADDTU[G[GHBAZBBBBAHHGHFGF]AB
DGGV[G[G[GHHHHHHHHHHGHFGFFFF
GDAVG[G[FFFFFHFGGGFHGHFGGGGF
AGBV[G[GFABAFGGGFGGFGHFFFFGF
BBGVG[G[FCGBFBHFFFGGGGGGBFGF
BHHVHFFFFGDGFFFGBGFFFFFFFFGF
GBEGGGGGGGFGGGGGFGGGGGGGGGGX
