28 24 2 600
parrots
0 20 27 0
25 23 0 8
FBFFGGFGFFBGBFFFGGBGFBBBFFFG
GGGFGFGGBFFFGGBGGFFFFFGBGGGG
GBFGBGFGFFGBGGFBBBBBGGBFFFFG
GFFGFGBBBGGFGFFFGFFFFGFFG`FB
BKKGKGFGGMNGFGF`GGFBGGBFB`GG
GGGGFGEGGOPGGFFFGFFFGFFFFFBF
GVFGBGKGGFGGGGFGGGQGEGGGRGKF
GKKKKGGGQLGBYGGLKKKKGLLKBGAB
GKGBGKFGGGGKGBGGGBGGGGGGGGKG
KBGBGBKGKFGKGAKGGBGKGBGGAGGG
KFGKGBGKGKGGFGQGGKBAGGKKKKKK
GGGXKGGBGKGKGGGGKKKKBGGKGGBB
BGKGGBQGAKGGKBQGBVGGGKKKKKGK
GBBGYGKGKGBGBGEXKKKGBGGKGGBG
GKGGKGKGGGGGKGKGKGYGKGGKG`GK
XGGAGGXGAGGYGGKGKGKGKG\KKKGG
KKBKGKKGKGBKDGKGTUBGKGGGBGGF
[KGKGBKGKKKKDGKGIKKFBGKKKKGG
[G`AGKKGS[WGDGKGI[[[KGBGBABG
KKKKGGGGGLGGLGKGILKKFGLBKLK[
]GBGBBKGGBBFBBBBBG`GBBBBBBBB
GKGKGKKGKGGKKGKGIGKGWWWGIGGA
BEEKDDGDDKGBKKKGILLKKGKKGGKK
FKBGBGFGXGGEGBK_BBGGBZ^GJ]GB
