28 24 1 600
pegleg
0 23 27 23
BCFCCCFCCCCFCCCFCFCCFCCCCCC^
CCFCFCFCFCCCCCCFCFCCFFFCFCCF
CCCCFCCCFCCFCCCCCCCCCCCCFCCF
CFFFFFFFFFFFFFFFFFFFFFFFFFFF
CFFFFFFFFFFFFFFFFFFFFFFFFFFF
CFFFFBFGFCFGFGFGFGFGFGYAZFFF
CFCCCDCGFCCGFBFGFGFGFGDBFFFF
CCCFFDFGFCFGFGFGFGFGFGGFFFFF
CFFFFDFGFCFGFGFGFGFGFDCFFFFF
CFFFFDFGFCFGFGFGCGFGFGCFFFFF
CFFFFDFGFCFGFGFGFGCGFAGFFFFF
CFFFFDFGFCFGCGFGFGFGFWGFFFFF
CFFFFDFGFCFGFGFGFGFGFGGWBFFF
CFCCFDFGFCFGFGFGFGFGFGGFFFFF
CFFFFBFBCCFGFGCGFGFGFGGFFFFF
CFFFFDFGFCFGFGFGFGFGCGGFFFFF
CFFFFBFGFCFGFGFGFGFGFGGFFFFF
CFFFFDFGFCFGFBFGFGFGFGGFFFFF
CFFFF_FEFCFZFGFGFGFGFG\FFFFF
CFFFFFFFFFFFFFFFFFFFFFFFFFFF
CFFFFFFFFFFFFFFFFFFFFFFFFFFF
CFFFFFFFFFZFFFFZFFFFFFFFFFFF
CFFFFFFFFFFFFFFFFFFFFFFFFFFF
]FFFFFFFFFFFFFFFFFFFFFFFFFFG
