28 24 4 600
seaside
26 23 2 1
3 0 0 10
9 13 14 23
12 23 27 6
`JX]FGGGFGGGGGGGGGGGGGGGGXXX
GJGMNGFGJGFQSFGJSTUJRJJJJMNG
GJGOPGJGFGGJGGGFGGGGBFGZ[OPG
GJGFGGJGJJGJJJGBGQJSJJJRJJJW
GJGFGFJGGJGGGJJRJJGFGGGGGGGZ
GJGFGGJGGCSQGJ`GGGGGGYBKJKKJ
GJGFFGJGGGGJGCFCFGAGGKADDDDG
GIGF`GJGFJGFGJGGGGKGGKDDADAD
GGGFBMNGGJGBGFFCFGFGGKAEADDB
KSKKJOPFGCRVGJGGGGFXGKDDADAD
GJGGGGGGGGGJGSGCFF[FGYDADGAA
GJGVRJJCSVGJGJGGGGFGGKADDGDA
GSGJGGGGGJGJGJFCFGFGGKADDGDA
GJGJGVSGG]GJGWZGGGFK`KDDDGBA
GFGJGJGQGGGJGJGCFFBGBKDDDGDD
GGGJGJGJTUJCGJGGGGKGFKDDAADD
VRJQGJGGGGGGGJFCFGKGGFDIIIIB
GGGGGJGJRCJJJCGGGGKFGKGGGGII
GMNJJVGFGCGBFGGFIIFGGRHHHGGB
GOPGGGGGFGFGGGGGGGKGFKGGGGMN
GVTUJJQGCFGCQIICFGKGGFGRSGOP
GGGGGGG`FBCGGGGGGGKFGKGGHGBV
GVTUVJQGCFGGJHHHIHCBBF\GRIKI
BCXB`GGGSBCF]GG^JBGGVGGGJJ]_
