28 24 4 600
captain
22 23 13 10
4 23 27 21
2 5 26 23
0 11 2 3
EFG[[[[[[[WGGAGGGGGFFCFQACAG
EFG[[[[[[[FGFFBGGGGGGGFQAGAG
EFGFFF[[[[FGFEEFFFFFCGGQWAWG
EFGFBF[[[[FGFFBFBG``FGGXBCGB
BFBFBF[[[[FGGFFF`MN`FGGQQQQQ
BF]FAFFFFFFFGGGGE[[`FGGGGGGG
AFFFDDDDDFAFFFGFFOP[FGGDDDDG
DGGCGDDFDFCBFFGGF[[[FGFFGGDG
GGGFGFDFDFFBBFFGFFFFFGGGFGDG
GGGFBFBFBBBFBGFGFGGGGGGMNGDG
XXGFFFFFFFBBFGGGGGGGGGGOPEDG
]XGGAGGGGGGGTUGGGFGGFGFGFCFG
BXGFFFGGGGGGGGFYGFFGGFGGFBFG
XXGGFGGYGGMNGGBAGGFGGFGGCFFG
GGGGGGGDGGOPGGGBBGGGGGGGGGDG
GGGGGRGGYGGGGGGGBAGGGDGGFFDG
RGGGGHHHHGGWWWGGGBBGGKJGFGDG
GGGGGGGGGGWWGWGGGGBGGGIGFGDG
BAWGGGAGGWGGGWWWWGGBGGGGFGDG
[[WGGGWWWGGGGGGGWWGGBGGGFGDG
[[WGGGGWGGRGVGGGGGWGGBGGGGGG
[[WYBGGGWHHHHHTUHWGGGGGGXSZG
QQQQGGGGGHHHHHHHHGQGGRKKAAKK
\```]GGEGWLLLLLLLGSGGI]_CBG^
