28 24 0 600
arctic
^QBBBBBAQBGCGGBGAQBADAGBFBFB
GQBBBBBAQQQSBABDBQBDGBDDFGFG
CQBMKKNAQBCCGMNGBQSGGMKNFBFB
GQGIBEJAQQQQSOPGGAQDGOLPDGGG
GBGOWLPAQBCGGCBGCDQGGGGGGUQW
CQCGCGGAQQQQSGGBCGQSGDQTVCGC
GQGCGGBBWGBGQQQSGABQGGQ_GGGF
GQGRQQQQQBGBBGGQQSBQSGQQQSCB
GQCQAAQDGBXGGGXGBQGGGGBBBQGG
BQBQAAQGDMKKKKKNGQGQQQQQQQGB
GBGGCBQGDIIG\GJJGQGGAGGCGGGG
GMKKNGQDGIIGGGJJGQGMKKKNGFGC
COWLPCQDGIIG``JJGQGOLLLPGBGG
GGGCGGQGDOLLWLLPGQGGGAGGCGGC
WQQQQQQDGDGGDGGDGQQGRQQSGQQQ
GGGGGGQQQQQQQQDDGBQGCBWQDDDG
WWQQQQQWQEBGBQQQQQQGCGQQDBBD
ZZQWGGGGQGGGGBEQGGCGGCQGDDDG
ZZQQGRQQQEMKNGBGCMKKNGWBABAB
AAAGBGQWQGOWPBERGOLWPGQGRGRG
BBMKNGQGQGBGBWGQGCGCGGQGQGQG
AAOWPGQGQQQQQQQQGQQQQQQBQBQB
BBBAAGFGYGGAGYGQGQBAGGQGQGQG
GABBBBBBBBBBBBBGGGBABBQBBCBB
