28 24 0 600
diamond
BGGAGAGAGAGAGAGAGAGAGAGAGAGB
GGDBDBDBDBDBDBDBDBDBDBDBDDGG
ABHHHHHHHHHHHHHHHHHHHHHHHBAB
FCWABGGGGGGBGGGBGDABBBAGHCFC
GBHBGRQQQQWQQSGHGGBABABZHBQG
GCHAAQ^QDWDWYAGHDBBAABAUHGQC
BGHABQWDWDUQAQGHGHHHHTVGHGQG
FGHBAQQQTVGQAQGHGHBGGGCGHCQG
GBHGBGGQGGGQAQGHGHHHGGGCHBQB
FCHQQQGQGFGQAQGHDGBHBAGGHGQG
GGHGGGGQGHGBABGHHHHHGWSBHGQG
AGHGBGBQGHGGAGGBAAABGQAGHCAD
FBHGHHGBGAMKKNGGBABGCQADHBFG
GCHGH_GABBILLJGGGBGCBQCGHCQC
GGHBHHGHHHHHHHHHHHHHDQGGHGQB
FCHGGGGWGGGADGBAGDGHBGGGHGQG
GBHGQGGABGDBGGGDGDAHGAFGHBQG
FGHBQABRMKNDGMNGFGBHWWHGHGGG
BGHGQSGQILJGGOPGHGAHWWHGHGQB
GCHGBGGQDAYGDAGGHABHHHHGHCQG
GBWBGAWQ\BDBGBBDHBGGGGGWWBQG
FGHHHHHHHHHHHHHHHHHHHHHHHGQC
GBCAGGAGGAGGAAGGACGBAGGAGAFB
BGGBCBACACGBDBACBBAGCBABCCBG
