28 24 2 600
manager
14 7 23 23
6 11 7 21
AAAACBGGAGGDYD\GCCADGCBBBBBB
ACCCCFGDDCCGRWWWSGCGCGFADDCA
AAAAAFCGCGGCQWWWQGCDXCFAADAA
CDDCAFCGGCRQQQQQQQSGGGFACADA
CAAAAFGDGCGAAAAAAAGCGCFADDDA
BBBBBFGCGGAAAAAAAAAGDGFAC`DA
ADDDAFGGCAAAZAAAZAAACGFBBBBB
AADDAFCGCAAAAA]AAAAACDFCDADC
ADADAFGCGAAAAAAAAAAACGFCADAC
ADDAAFCGCCAAAB^BAAADGCFAC`CA
ADDDAFGCGGCAAAAAAACGCDFAAAAA
BBBBBF]GGGBBBBBBBBBCGGFADCDA
AAAAAFGCGAAABBBBBAAACGFBBBBB
ACDCAFCCAAAABBBBBAAAACFADCDA
ADBDAFGAAAAAABBBAAAAAAFAADCA
ADCDAFCAAAAAAAAAAAAAAAFADACA
AAAAAFGAAAACAAAAACAAAAFADDAA
BBBBBFCAAAADAAFAADAAAAFACDDA
ADBDAFCCAACAAAAAAACAACFBBBBX
ACCDAFGCBDAAAAAAAAADBCWGABAG
ACADAFCDAAAAAAFAAAAAACFBABAB
AACAAFGGCAAAAAAAAAAACGFFAFAF
ADDDAFCGCCAAAAAAAAACGGFBBBBB
BB_BBFDCDGCBAAAAABDGGCFGABAG
