28 24 4 600
quibble
27 23 10 1
16 20 14 8
4 3 21 23
21 10 16 10
^CHCBCFGBCBAFFFFFGGBGAGG_GBG
GCBGBGBCBCGF[[[[[FCABCBCBCAC
C`BBF`B`FGFFFFFFFFFCBGAGGACG
BCBC]CBCPCF\DCECCAFBCBCCBCAB
XPPIQJPTOUFCCCECCCFCGAGACABG
CBBCBBRBCCFGCCECCGFCBBCBCBCB
BCBBABCCBCFCEEYCCCFGAAGACBGA
CBARSBBABCFCCCCCCCFCCBBCBGAB
BCBCBCBBCYFADDGDDAFCACCACACG
BBCBBBCBBBDFFFFFFFGBCAGBCBBC
OOQIPJOQIQXFXGGAGFGCA]CBBAGB
WGGBGGSGWGBFGWAWAFCCBABACBCA
GBGGGGGGGGGFW`CGWFCBCBCBGAGB
GGG`GDY`GGGFACAWAFCBCGCABCAC
GWWWWBWWWWGFWDWDDFAABABBCBCB
GCGGG`GGCGGFDAWGAFCBBACAGBAG
BGWGCGGGBGGFGAGGWFCAGBCBACBA
XHHHHHHHHHHFCWGDGFACBCCGBBCB
BGCGG`CGCGEFGDAGAFAGAGBBCAGA
HHHHHHHHHHXFCACWWFCBBABBGBBC
BAGBBAGXAGCFGWGG]FABCAGABCAB
GBABABAGBCGFFFFFFFBGABBBGBAB
XBABBGXABFF[[[[[[[FFCCCCACAG
ZWBGABGBGFFFFFFFFFFFAGBGBCC]
