28 24 1 600
natives
5 15 27 3
GBABABAGCGHAHGAGDC`CGC`HBBAA
AGBABGBBHDG^GCHGFHHHHHCHBAAB
BBABACAAHHHHHHHD`HAAAHGHBBAB
GABGBGBBBBBH[BXGGHAAAHCGBBBG
XHHHHHHHHCHHBWXGFHWAWHHHHHHH
DBGDDHDHGCDH\BXGWHGWGCGGCGCG
GMNGBXDHDQGHHHHHHHGGGMKKKNCB
GOPGGHGHDHGWDGDWDGGYGOLLLPGC
GGGMNHDQGHGWGWDWGWGWDAAAAAGG
GGGOPHGDDHDGGWGDGWDGBBBBBBBA
RDDDBHHHHHHHHHHHHHHHHHHHHHBX
DD`DSHWAWGAADADADDDDADEHGFFG
D`FDDCCWHDABDDDDDADDDDDHBGGG
DDDDDAGDHADDAADADDDADDDHBBGB
HHHHHHHGHZDDADDDADDDDFDHGFBG
BBABA]HCHHHHHHHHHHHHGFBHGFGB
BAABFAHGGDGGCDGDDGHACFGBGFBF
ABABABHDHH`HHDDYGGGAGGFFFGGB
ABFBBBHGGCHGGGYDBGHHHHHHHHFX
BBAABAHCGGCGGDDDGGHGGGYGDGGD
AAFBABHHHHHHHHGBGCFGFHHHHHHH
BABABBABABABBHDGGFGGDGGDDDGD
ABFBBBBBABBABHB`FEDFHHHHHHHG
BBBBABBBBBABBB_FBGDGCDGDDGG[
