28 24 0 600
jumping
CGCDAWGCCCGGCGGCGGCGHBCAGCAC
GAGGDHCBGG`C`D`CGCBGHGBCCGBG
WMNWCHGCGMKKKKKKNGGGHCGBBAGG
GOPCGHCBCOLTIJQLPGBGHBCCGCBB
AGWG`HCGCGGCCGCGGCGGWGCBGACA
WWACWHDHHHHHHHHHHHHHHCGCCBCB
CGWG`HDHGYGGGGGYGGG\HAGCACGG
CAGACHGHGBGGGWGBGWGYHCBACGBC
WWWW`HDHGYGWGGGWGGGBHBACGAAC
WAWAGHDHGWGGGWGGGWGGHABGBCBG
FFFWWHGHGGGWGGGWGGGWHCGACCCG
CCCCCHDHGWGGGWGGGWGGHHHHHHHX
CWFFFHGHGGGWG_GWGGGGHCWGWGWW
GCCGCHDHGWGGGWGGGWGGHGCACGAA
CGGCGHGWGGGWGGGWGGGWHWGWGWCW
CCGCCHDCGGGGGGGGGGGZHGAAGACG
GMNCXHHHHHHHHHHHHHHHHGWCWWWG
COPCCSDCA`DBXCWCACWGXAACGAGA
CGCGGS`^BDAFSGRGWGRCRWCGWCGW
GGXCCSBDGB[ZSGRGSGRGSGWWACAC
GCCGGSSSSSSSSCRBSBRGSCAGWGWG
GGXCCSAWWW[WSGRGSGRCRACDDGAG
CGCGARWWAWWWXGWGWGWGSAAGACCA
CCGCCXWWWWWWRCDCSGCGSCWDWGCW
