28 24 0 600
shallow
XWHWWWHWWWWHWWWWHHWWWWWWWWWX
WWHWFWFWFWFFWFFWFWWFWWFFFFWW
WFFFFWFWFWWFWFWWFFFFFWWFWFFW
WWWWFWFFFFWFFFWWWWWWWWWFWWFW
HWFWFWFWWWWWWWFFFWWFWFWFFWFW
WWFWFWFFFWFFFFWWFFFFWFWFWWWW
WFFFFWFWWWFWFWFWFWFWWFWWWFHH
WFWWWWWWFWFWWWWWWWWFFFFFWFWW
WFWFFFFFFWFWFF`FFFFFWWWWWFFW
WFWWWWWWFWFWWZGZWWWFWFFFWFWW
WFFFFFFWFWWWZGGGZFWWWWFWWFWH
WWFWFWWWFFFF`G_G`FFFFFFWFFWW
HWFWFWFWWWWFZGGGZWWWWWWWWFFW
WWFWFWFFWFWFWZGZWFWFFFFFWFWW
WWF^WWFWWFWFFW`WWWWWWFWWWFWH
WFFFFFFWFFWFWWWFFFWFWFFFFFWW
WWWWWWFWFFWFFFWWFWWFWFWWWWFW
WFFFWWFWWWWWWWFWFWWWWFWFFWWW
WFWFWFFFFFFFWWWWFWFFFFWWWHHH
WFWWWWFWWWWWWFWFWWWWWWWFWWWW
HFFFFWWWFFWFWFFFFWFFFFFFFFFW
WWWWFFFFFWWFWWWWWWWWWWW\FWFW
WFFFFWWWFFFFFFFWHWFFFFFFFWFW
XWWWWWHWWWWWWWWWHWWWWWWWWWWX
