28 24 0 600
victori
CCCCCCCCBBHAHAHGGDGAGGGGAGGY
CAGBBGACHBHEHEHDADAADGHBZBZB
CRQQQQSCHBHBHBHGDMKKNAHHHHHH
CYGBBGAGHBHBBBHAGILPJDBGABGD
CRQQQQSCHBHHHBHDGIOOJGMKKKNG
GCABCCAGHBBHABHGGDDDGDIWWWJD
CMKNBHHCHHBHBBHDDGAGDGIPOWJA
CIWJCHBCHBBBBBHGBGDGGGGDAGGD
BGCCCHHHHHHHHHHXXXHHDDGDADGG
CCCGCGCGCGGGGACCBCCHGMKKKKND
HHHHHHHGHHHGABC^CBBHDIPLPLJD
GZHWAWHGHBHGHHHHHHHHDILPLPJG
CHHWYWHCHGHGHGGGGGBHGILLOLJG
CEWWAWHGHCH\HGFHHHHHBGGCGGGB
GHHWWWHGHGHHHGGHGB[HEZEZEZCG
CBHHHHHGHGGCGGCHGHHHGC```CGG
CHHGGGGGHCHHAHGHGHGAGHHHHHHW
GWHGHHHGHGHABHGHGHBEHCGCCGCG
CHHGHEH_HBHBEHCHWHBBHGHHHHHG
GBHCHGHHHHHBBHGCGHBBHCHAWAHC
CHHGCGGGGGCGGGCGHHHHHGHWWWHG
CBHHHHHHHHHHHHHCGCGCGCHAWWHC
GHAWHBHWHBABWBHHHHHHHHHHHWHC
CGCGGCGCGCCCCCGCCCGGCCGGGGGG
