28 24 3 600
mercury
25 17 20 8
27 19 19 23
24 23 17 20
GGGGGHBHGBGGEG_GGDGHGGDGDDGG
GHHHGHGHBGGMNGGMKNGHGWWWWWWE
GBGHGHGHGBGPODGIOJGHGWWGFGGG
GH[HGH`HGGDGGBGGCGBHDWFGGGFG
GH[HGHGHGMKKNCGMKNGHGWGGFGGG
GBGHXBEHCIPOJGGIOJCHGWWGFGFW
GHHHHHGHGGGCGCBGCGGHDWFGGGGF
GAAABHGHBGBGGGYDGGEHGWGG`YYA
BBBBAHGHGMKKKKKKKNGHGWWBBBBZ
AGBBHHGHEIPLPLPLPJDHWHHHHHHH
ACCHHGGHGIPLPLPLPJBHGHCCGCCG
CGGHGGFHGIPLPLPLPJGHGHAHHHHG
GCAHGFAFBIPLPLPLPJCHGXCCWHYC
AGBHGFAFGILOLOLOLJGHGHHHHHBG
BBGHGGCGGGCGBGDGBGDHCHAAGHGH
BHHHHHFHHHHHHHHHHHHHGHBBBCGG
GBEGAGGGGGGGGGGGGGGGGHHHHHHG
HHHHHHHHHHHHHHHHHXHHGGADG]H^
\WWWWWWWWWWWWWWFHGDHGBBDA`HH
RQQSWFWFWRQQQSWWHHGDHHDGDDB]
WUVWFWFWFWTWVUFWHGHGAGHDDBG[
WWWWWWWWWWWWWWWWHCHBWGGHBG[G
WAAAAAAAAAAAAAAAABHHHBGGH[G[
WWWWWWWWWWWWWWWWWWW[HBFG]H[G
