28 24 0 600
cleaver
BCGGGCXGCGCGGH`CHGGGGGGGGGGW
HHHHHHHGHGYCCHCGHGHHHWHHHHHH
CGGGCGGGHC_GGEG`HGHGCGF``GWG
XHHHHHHCCCGCGHHHHGHGFFFFFFFC
GCGCGCHGHHGHHHGGGGHGCGCGGCGG
CMKKNGHCGHCH[HGHHHHXHHHHHHHH
GIPPJCHHGHGHGHGXGGDDGGGDDGG^
AIOOJGHACHGH[HGHHHHHHHHHHHHH
BBGBACHBGHCHGHGHGDGADAADGDGA
ACCGBGHHBHGH[HGH\AGDDBBWGAAD
BGBCFGHBCGCBBHGHHHHAGXDAGXBG
ACCGGGHHHHHHHHGA`GHDADGWWGWG
BGCBGFHBGABAGBBAHGHGWGADBDGG
ACACFBHABBGBAGHHHGHAGWDDGAGW
CGHGHAHBEBABBBGBHGHHHHHHHHH`
FGHGGCGAGGBAHHHHHGDGGDGGDGHG
GCHHHHHHHHHHHBBBGCGDYDGYGGHG
ABGCHBBBBBBBBBBHGGGMKKKKNGHC
BGBAHBBRQQQQQSBHCHGIPPPPJDHG
BACBHBBTVWUTVUBHGHDIOLWLJGHG
CCBHBBBBBBBBBBBHCHGGDGXGDGHC
ABCHBBBBBBBBBBBHGHGGAGDGAGHG
BABHAAAAAAAAAABHGHHFAFFAFHGG
CBCHZBBBBBBBBBBHCG`GDGGDGGGG
