28 24 4 600
confuse
27 11 13 23
27 23 13 8
0 8 4 18
2 17 16 6
BDBFBDBBDBBFDBBBDBFBDBBDBFBB
DCCBCCCCCCFBCCCCCCFCCCCFCBCD
BCFCCCCFCCCCC`CCFCCBFCCBCFCF
DBCC[CCFBFCCF[[CCBFCCC[CCCCB
BCCCFFCCCCCCC[[CCCCCACFCCFCD
FCFCCBFCFBFCCFBCFFCBFCCCCCCB
DCCCCCFCCCCBCCCCGCCFCCCBFCCB
BCCFCCCCCFCBCFCCFYCCCFCCCBCF
]DBXBDBFDBBWBGBBDBBBDBBFDBBB
HHHHHHHHHHHHHXMKKNMKKKKNMKKN
BBGAGABGAAGWHGIWWJIWLOWJIWOP
ACACCACABCAGHDGGDGGDAGGAGAB]
CBBBABGWGABAHGBGBDGGWGGWGWBD
ACAGCGAABABBHGDDDG`DGGGGAGBD
BBCBABBXBCGGHDGEGDBBBGGGWGB`
CCABBGCADBA^HGDGGBBYBBGGGABD
CHHHHHHHHHHHHDGDBBB[BBB`GWBD
BH]BFBBBBF_DDDD`BB[\[BBGGGB`
CHBFGYFFBFDGFGDGDBBBBBGGAGBD
GHBFBBBFBXDDXDGDDDBBBGGGWGBD
CHBFBFFBBFGDXDXDDDDGDGAZWGBD
GHBBBBBBBFDDBGGDGDGDDRQQQSBF
CHHHHHHHHHHHHHHHHHHHHTWWWUHH
CBCGCCGCBCGCCGCBC`CGWC`CDWX]
