28 24 4 600
minster
0 17 15 9
1 0 25 9
11 13 15 1
25 4 22 17
B]GAAAWBGAGBGGHBAGDGABGADGAB
GABWBBAGBWGGBGHGMKKNABDBGDBG
GWABAGWGAGBABGHGIOLJBDAGYACG
GGAGWGAGWBGAGGHBAGAGDADBMKNC
^GWGBBBBGGBWFBHGBBABGDGDI]BG
HHHHHHHHHHHHHXHHHHHHHHHHHHHH
`CGAABAGCGGCGAGBHGG``GGBADGA
`GABBGCACAGCGDGGHADGGYGGBDGC
CBAGCABABCBCGGWGHBGAGDGGGCG`
AABBGCGBGABGFGFGHGGDGGDAGGC`
CBGGABGCGCAWFWFXHGG`ABGBDDGB
HHHHHHHHHHHHHWWXHHHHHHHXHHHH
ADGBGDDGBHDCCGYGGGHGCGGGCGCW
BBADG`GBGHC]BGCDDGHBFGCGGGCG
ADDGRQS_CFCBGGGCACHFFFFBFFGC
BGGBTVUBGDCGCGFGBCHGCGBFFBGG
HHHHHHHHHHBCGCBGCCHCFFFFGGGD
]GCAAGCACHDGAGCGFGHGFZGACGGG
GGABBBABAHGGCGGCDGHCFFFFFGBG
GFBFFFFGBXCYGGACGGHGFBFBFGXG
GFBFBAFBGHBXGDDDGFHGDGGDGGGG
GFFFABFFFHGGGBGCGCHDGGAGDGGG
GBAABAGGBHGGGAFGGGHGRQQQSGGG
BBBBB[GB\HBGBBFCBGXGTWWWBBGD
