28 24 0 9500
PRELUDE
ABGGDAGGGYAAWGIBGGDBDGGAGGGB
BBGCGIBGBBBBJGIGBHLLLBLLLBLL
GGCGMHLLLLLLPBIGHPGGGBGCGBCG
KCKKAJAGGGCGDGIGJGGCCGGGGGGC
BABGWJBBADGCGDICJBGGGCGYAAAJ
GBGGGJGGCMKKKKHGHKKKKNBBBBZJ
LGLLGJGACIGGGDGGGGGDGHKKKKKJ
CGGGGJCCGIBHLLLLLLLHGBGGBGGJ
GMGMGJACGIGJGBGCGBGIGDGGBGBJ
CIBIBJBACIBJCDMKNCGIBBHHHGGJ
BIGICJDACIGJCGOLPGGIXGCGHGBJ
BICIGJGBGIBJGBAWABGIXGBGHDGJ
BIBBBJDCGIGJGGMDNGGIXGCGHGGJ
BOLLLJBBMHAHNGIDJGMHHHHHHGGJ
CGGCGONBIGAGJDIDJGIBGGDGDAGJ
GAGGGCONIGWGJGIDJGIG`D`C`WBJ
GWGCGCDOHGHLPDIBJGOLLLLLLLLP
GMKKKNDCOGJGGGI^JGGGGCGGG\GG
GIBABONG_GWGGGIHHKNBCGCGBCGB
GIGBGAONGGONGCOLLLPGGHLLLGLL
CIGAGCGONGGONGGBGGGGCJBAAGGA
BICMNGCGWWCGONGBGMKGGJAACAGC
GIGIJGMNGONBBONGAIBBDJCDBCCG
BIBIJBIJGBOHHHPBAOLLLPBGBBGB
