28 24 0 8000
CITADEL
GGGGGDGGGGGABGGGCCGGGCGGCGBA
GGGDCAGGDABABDDCEBBBHBGCGBBB
GGGBCBBGGCCHBBGBBBGCHGBGABHB
GGBHGHBBGGCGHCBHCCZHHBHBCCHB
GBHGBHGGGBGBHHBHGHHHGGHGGHBB
GBHAHEBBBHBGCHBHHHGGDGHHHHGG
GGHCGGHCHBBGCHGGCHHBGZHGECGG
GGHBCCH^HGBZGHGBAAHHHHHZGCGG
ADGHHHHHGABCHGCBBCGGGGHBBCCG
BADCGGGHHCBBGHCGBBABACGHBCGG
GBGCGDGGHHABBHHGCCBHBGBHGCGG
GBHHGZCBHGHGCGGHGGGHBGGBBABG
GGAHHHHHGGGHGAGGHGBHBCGBGCBG
GBBHHGGGCGBHBHGBHHHAGCGHGCBG
GGCHGGCDHLLHBHHHHGGADBAHGBBG
GGBHGGBHLGGIBGGHGGBDDBBBHHBG
GBCHGGBJGGGOHBHGGHLLLHHHHBGG
GGHBGBHPBGGBOHHGHPGGCGGBGB\G
GBBBGHBGGGGGGIHBJGBGHBGCGBBG
GGBGGBGGG_GGGOHHHLLLBBGCGGGG
GGGGGGGGGGGGGGIHJGGBBGGGGGGG
GGGGGGGGCGGGGGIHJGGGGGGGGGGG
GBDCCCGCGGRQQQQQQQQQSGGGGBBG
DGCCGBBCGWWWWWWWWWWWWWGBCCCC
