28 24 4 4744
FRITTER
8 2 8 10
6 7 15 6
20 6 27 12
12 23 0 12
CABAGAAAAHCGABAAAAZHAGGDGBGB
_BCBBABBBHGBCBCBDBBHWGGGGGCG
DCBGBBCD]HCCGGGDGBGHGCBDBCXG
HHHHHHHHHHGGDGAGGGBHGBCHGGGG
BGCGGGCGCH`CXGHBHGGWGCBHBHBB
HHHGHHHHGHAGGCHGHGCHHHHHHHHH
BAGGBHAHCHBCG`HGHG`W]GAABAAG
DBDCGH]HGHHHHHHXHHHHGAAAAAAA
HHHGAABHCHBGCGGGGCGHBDBDBDBD
BDGBBAAHGHCGBGGBGCBHDBDBDBDB
BGCBGBBHGHGCBGGBQCGWBDBDBDBE
QQQQQQQQQQQQQQQQQQQQQQQQQQQQ
GBCGBQBGDGAQBGCCGACGGCGCGGGG
BAGGGGCGBBCQQQQBQQQQBQQQQQBQ
CCABACABAGGQAAGDGGQGDGGCGGGG
BGCGRGRQQQCQCCGBGGGGGCGGGBGC
CABDQEQABAGQGGCGBBB`G`GGBQBG
CBBBQBQBBCBQBGGGRQQQQQSDGBCG
QQQQQBQQQQQQGBGCTQQQQQUGGBGG
CBBGGGGAGBGQCGBGGGDGGGGGBQBC
GQGDGQCXGGDQGGGDGGBGDAGACBGD
CQBG\QBQABDQQQQQQQQQQXQXQQQQ
`QCBRQQQAQGQAAAAAAAAAGQCGAAA
BQBCGGCGCGBQ]BBBBBBBBBQBCBB^
