28 24 3 744
LAWLESS
17 13 20 23
0 14 6 12
8 3 22 23
ABGDAGGBGGCHBCBCBCBCBCB\GA[[
BCABBHGDGBCHCBCBCBCBCBCBCA[[
CGAGGHGGAGGHBCBCBCBCBCBGGA[[
GGCGCHBA]ABHCBCBCBCBCBGGGW[[
HHXHHHGBCBGHKKKCKKKKKKKKNWMK
BGBCBXEGBGGHAAACCBABAHLLPWOL
BGHGCHBHHHHHBBB^BDBDBHYAGDCB
GGCCHHHHGGGHHHHHHHHHHHBCBGCG
GCCCAGGHGDAGDDCAGGGGGHDZAAAA
AA``AAGHGRBBBBBBRXSGGHDGAACB
QQQQQSCHDQGGGGGGQGQDGHYCBCBG
AAYBGQCHGQQXDGXQQCQGGHADGGYG
BBBCCQGHCBQBDCBQCBQBCHBBBCAB
CBCAGQBHCBQDBBCQB]QGGHCAGAAG
]BGCCQQHGBQQQQQQQQQGGHGDCCBC
QQQBQUAHGBGBBG_GGBGCGHBDBGGB
ABCGCGBQCQQQQQQQQQQCBQCQQQQQ
AAGQGQCQGQBBGBBCCBQGCQGGGCGG
BBBQCGBQCQDCGCG`GGGGGQQQQQQC
QQQQBQQQGQBGG`GQCG`GBQGGGCGG
AAABGGCQDQQCQQQQQQQGCQCQQQQQ
ABAGDQGQCGBCGDGGCGCGBQGGGCGG
ABBAGQDTQQQQQQQQQQQQQQQQQQQC
BBCBCQGCGBGCGBCCGECGGQGGCGCG
