28 24 0 2544
RATION
BBAVVWBVBGFFFFFFFFBFVBWVVAB\
BCAVWDVBABFAWAAWAFCFGVDWVAAB
^CXWDVCGBGFWEWWGWFCFGGVDWXDC
VVWDDAGGGGFAWBBWAFCFGAGDDWVV
VWDDDBBGGGFAWBBWAFCFGDGDDDWV
WDVGACGGGGFWGWWGWFCFGGGGCVDW
BVGCBCFGFFFAWCCWAFCFGGBGGGVB
VGGGGGFCFAFFHCCHFFCFGGABGGGV
VVGBGGFCCCCCCCCCCCCBGAAABGVV
BAARSCFFFFFDFFFFDFFFGDMNBGGB
GCCTUGGBGGFDFAAFDFGGGAOPGCGG
GRSGBBGGGGFFFAAFFFGGBAGGMNGG
CTUGGAGGCGGGGBBGGGGGGDGGOPCG
GGCRSACBAGGBABBG_GGBGGMNAGGG
BAGTUACGFFFFFFFFFFFFGGOPCGGB
VVGAACGGFGCGGBGGGCGFGGBGAGVV
V`GCBCAGFWFFFFFFFFWFGCABDG`V
BVGGBCBCFBGCGBGCGGBFGBBGGGVB
WDVGGGCCFGFFFFFFFFGFGGGGGVDW
VWDDDGBGFCFDGGCGGFGFGBGDDDWV
VVWDD`GGFGFGFGGFBFCFGG`DDWVV
ACXWDVGGFWFGFBGFGFWFGGVDWXGA
BAGVWDVGGGBGFBZFCGGGGVDWVCAB
BBCVVWBVFFFFFFFFFFFFVBWVVCBB
