28 24 4 3744
TOBACCO
0 21 27 0
25 6 26 6
0 1 1 4
4 5 26 6
CCCCCCBCWCWCQCQCQCQCQCWCWXWG
]LCCBBCCCCCCCACACACACACCMNWW
J[IBB^BBBBBBBBBBBBBBBBBBOPXX
AKHHBBKKKKKKKKNCCACACACCCBWW
CGBHHCBXCCXWC`JKNCCCCCCCBBBC
CCBA]MKKKKKKKKKHHKNCMKNCBFBC
CCBCCIBAABBABABABBABBBJBA]GB
ACBCCIBBBBABBBBBAABBABJHHBHH
CCBCAIBBBABABBBA\BABBBJACBCA
CABCCIBBABBBABABZABBABJCABCC
CCBCCIBABBBABBBBABBBABJCWBAC
CCBACIBBBABBBABABBABBAJCABWC
ACBCAIAABABABABBBBBBABJAWBCA
CCBCCIBBBABBBBBAABBABAJCCBWC
CABCAIBABBBBBBABBABBBBJCABCA
ACBACIBBBBABABBBABABABJAWBAC
CCBCCIBABABBBBABBBBBABJCCBWC
BCBCBIBBBBBBABBBBBABBBJCABCA
CBBBHKWNLLLLLLLLLLLLLLPCCBCC
CBYBHCCCCVCCWCDCWCACWBCHHBAC
HHBHHCCCAAAAACWCACWCCCBBHHAA
]HHHBBBBBBBBBBBBBBFBBBFBBHCA
`HAHCCCJIJICCMKKKKN[[[BBAHCC
``C`CHCW[[WCCWGWGWGN[BCGC_CR
