28 24 4 8000
TOCCATA
2 1 1 6
16 12 5 17
19 22 20 2
22 0 15 16
BBBBBABBBABBBVVWAWBBYB]WAWBG
\W]WBBBABBBABVVWCWCCCCCWCWB`
BBBBBABBBABB_XXWCWCGGGCWCWB`
VVVVVVVVVVVVVVVVVVVVVVVVVVVV
XGBGBGBGBGBGBGBGBGBGBGBGBGG`
DGGGGGDDGGGGGCCGGGGGDDGGGGGD
DGGFGDDDDGFGCCCDGFGDCCDGFGDC
CDDGDDWWDDGCCWWCCGDDWWDDGDDC
NDMBNDDDDMCNCCCCMCNDDDDMCNDD
OKPXOKKKKPWOKKKKPWOKKKKPBOKK
MPDCDOPCCCCCCOPGGG`OLLPACCCH
PDDADDVCBBBDDVBCCDDBCCVCCCAC
DBCCDDVCCB[BDCVC]DVVVVCCACCC
DDCDDDBVCBDBHHVCFDBVCCDDDCCA
ACCADBBBVCBCCVVBBBBVVCADDDAA
DACDBRQSVCCDCV[G[G[GVVCCAADC
DDDBRUTUVCCBCVGGGVVVVCACCDCC
DDBRUGCCWVCCCVVVVVCBCCCCAACC
DB[QWWDDWCVCVAVCCCACACADDAAC
B[GQWWCDDCCVBCCBACCCCCCADDCA
BG[TSCCWWCCCVVVVVVMNCCDDDCAC
B[G[TQSCDCCCCCCACCOLNCACACAD
[G[G[GTSDCAAAACDDAC]HHCCADDD
G[G[G[[TSCCCCCCADDCC^HCCADDZ
