28 24 3 7000
UPSTART
22 5 12 15
25 2 0 14
12 8 25 11
GGGGGGGGGBGGGGCAXSGGGGGGGGGG
GGGGBGGGGGGGGCCRQUGGBGGDDGGG
GGGGGGGGGGGRQQQQUGGGGGDDD]GG
GGGGGGGGRQQQFVVQGGGGGDDMNDDG
GBGGGGGG\GGQQQQUGGGGGDDOPDDG
GGGGGGBGTQQQQQQGGGBGGG]DDDGG
GGBGGGGGGGGGQQUGGGGGGGGDDGGG
GGGGGGRQQQSZQQ`GRQQQSGGGGGGG
GGGGRQU[[[QU]`TQQ[[[TQSGGGGG
GGGRU[[RQQQBCCBQQS[[[[TSGGGB
BGRU[[RUGGTACCCQZTQS[CCQG_GG
GGQCC[QGGBGSBCAUGGGQCCCQGGGG
GGQCCRUGGGGQGBRGGGGTSCCQGGGG
WGTSCQZGGGAUGGQGG^GGQCRUGBG`
GWWQCQWWWWRBGGTAGGG`QFUGGGWW
CCCTFQCCZRUGGGXSWWWWTUWWWWCD
AACCTUCCRUMKKKNTSCDDDDDACCCC
CCCCCCCRUMHBBBHNTSCCCCDDDCCC
CYACCLLMKCBBNBCMKKKNCYCCACCC
CAWCMMKIHMBCPBCIHIJJKNCCCCXD
CCCPPICIMCBCIBCOJHHNCCWCCCDD
ACCWZICCOCBWCBCPCKNCNCCCXDDC
CCBCPCCCWBBCCBBWCCJCWDDDDCDC
FCCCWCCBBBFCCFBBBCWCCCCCCCCF
