28 24 2 6000
OCTAGON
0 15 0 19
27 23 23 5
^XBCCBCCCCBACAACCBCGYAGCGCCB
XBCCBBBCCHCBACBCBABGHCGAGGHC
BCCCCBCC\HGCBCCBGCHGHGHHHHHB
HHCHEHHHHHHHHHHHHHHGHGHGYHHC
BHCHCCCCCCCCCCCCCBHHHCGBBBGB
CHCHCHHHHHHHHHHHHHHHHHHGHHHH
CHCHCCCBGYGGBCCCCHAAAAHCHAAA
CACHCHCCBBBBBCCCCHBABBGCGBAB
CHCHCHCCCCCCBCC``HAACGGHGCAC
BCBHBHHHHHHHHHHHHHABBCHHHBAB
VVVVVVVVVVVVVVVVVVVVVVVVVVVV
VCGYBGVGAGDGVGABVGAGAGVBCACG
VGVBVGVGVGVGVGVGVGVGVGVGVBVG
BDGGGAGDBGBCGCGBGGGCGCBGGGCB
VGVGVCVGVGVGVBVGVGVGVGVGVCVC
]GVCGGVGBCVGGCV_GCVCGGVBBGVG
VCCGVBCCVGGGVGGGVCGGVGCGVGCG
VBBBVBBGVBBBVBBGVGBCVGCXVGG`
VVVVVVVVVVVVVVVVVVVVVVVVVVVV
GVGBGVCBVZVCGGVBCWGDGWDAABAA
CVCVCVACVXVGVCVCWGGGDWAABCBA
GVGVCVBBXGWCWGWWGGCGGWCBCBCB
CVCVCVVVVBVGVGGCGGGBBVVVVVVV
GBGVBCBCBCGGVDGGGGGBB`G`GGG]
