28 24 4 4744
CHAOTIC
11 9 18 16
16 18 14 0
5 0 14 21
22 0 11 18
GGGGF]GGBBBGGGGGGBBBGG]FGGGG
GGGMKKKKKKKKKKKKKKKKKKKKNGGG
GGGIBDCCCCCCCBDBCCCCCCDBJGGG
BKBIBHLLLLLLLLDLLLLLLLHBJBKB
BHBIBJBYGACCCADACCCCYBIBJBHB
BHBIBJCRGQSDDADADDRGSCIBJBHB
B[BIBJCQBAAGGMKNGCABQCIBJB[B
B[BIBJCQAACGGI[JGCBAQCIBJB[B
BHBIBJCQCCGMNBBBMNBCQCIBJBHB
BHBIBJCQGGG]GGVGGGGGQCIBJBHB
GGGIBJCQGGGGGMKNGGGGQCIBJGGG
WWWIXJBBBBBBBXXXBBBBBBIXJWWW
GGGIBJGGGGGGGXXXGGGGGGIBJGGG
GG`IBJGVGVGLLBBBLLGVGVIBJGGG
GG`IBJGGGGGGFBGBFGGGGGIBJGG`
GG`IBJFFFFAGFBGBFYFFFFIBJGG`
GG`IBJAAABCGFBGBFCGAAGIBJGG`
GGGIBJCABCFFFBGBFFGDADIBJGG`
GAAIBJCBCCFGBBYB]FDDBDIBJAAG
ACDIBJBCCCFBB[ZBEFEDG^IBJCCA
CADIBHKKKKKKKKKKKKKKKKHBJCAC
ADDIBBBBBBBBBB_BBBBBBBBBJCCA
CGGOLLLLLLLLLGGGLLLLLLLLPCCC
GGGGGGGGGGGGGG\GGGGGGGGGGGGG
