28 24 4 2744
MAJESTY
22 22 25 19
20 22 25 12
26 22 3 16
24 22 2 2
_GGGGGGGGGGGGGGGGGGGGGGGGGBB
GMKKKKKKKKKKKKKKKKKKKKKKKKNB
GIGQGQGQGQBBAQBBBBBBBBAAGGJG
GIWWWWWGGGFFDGBBBBBBBAAHGGDG
GIWWWWWGYGFFDQBB^BBBAAHHGGJG
GIWWWWWGCFFFDQBBBBBAAHDHGGCG
GIWWWWWGCGFFDQBBBBAHHHDHHGJG
GIWWWWWGCGGGGQBBBBAGGGGGGGDG
GIFHHHHHHHHHHHHHHHHHHHHHHHNG
GIGBGHHCACCCCCCCCCCCCCCCCCJG
GIGHGHHCCCCCRQQSCCCCCCBCCCJG
GIGHGHHCCRQQQCCCCYCCCBBBCCJG
GIGHGHHCQQZZQCCCXXCCBBBBBGJG
GWGHGBBCCTQQUCCCCXCCCBBBCCJG
GIHHHHHCCCCCCCCCCCCCCCBCCCJG
GIFFFHHBHHHHHHHHHHHHHHHHHHJG
GIFGFFHGGGGGGGGGGGGGGGGGBXJG
GIWWWWAGGG`GGG`GGG`GGG`GHZJG
GIBBBBHHHHHHHHHHHHHHHHHHHHJG
GIBBBBHBHHBB[HGGGGGGGBBBBGJG
GIBBBBPCCHBB[HG[[[HLLLLLLLPG
GIAAAPCCCCABGGG[[[JGGGGGGGGG
BOHCPCCCOLLLLLLLLHJG]G]G]G]V
BBGGGGGGGGGGGGGG\IJGGGGGGGVV
