28 24 4 270
REVENUE
16 23 9 19
12 23 9 19
5 23 9 19
2 23 9 19
BBBBBDBBBBBDBBBDDBBBBBBBWBB^
BQQQQQQQQQQQQQQQQQQQQQQQQQQB
BBBBBDBBBBBDBEBDDBBBBBBBBBQW
QQQQQQQQQQQQQQQQQQQQQQQQQDQE
ZBFBAAAAAAAAADFBBBBBBBBBQDQB
EGBFDDDDDAAAADFBQQQQQQQBQDQB
FBGBFDDDDDDDDDFBQBDDC\QBQDQB
EFBGBFDDDDDDDDFBQBQQQQQBQDQB
BBFBGBFFFFFFFDFBQBBBBBBBQDQB
BBBFBGBGBGEGFGFBQQQQQQQQQDQB
BBBBFBGBGBGBG_GBBBBBBBBBBDQB
BBBBBFFFFFFFFGFFBBBBEBBBBQQB
BBBBBBBBBBBBBBBFFFFFFFNBBBQB
BBBBBBBBBBBBBBBBBBBBBBONBBBB
BBBBBBBBBBBBBBBBBBBBBBBONBBB
BBBBBBBBBBBBBBBBBBBBBBBBONBB
BBBBBBBBBEBBBBBBBBBBBBBBBONB
BGGGGGGGGGGGGGGGGGBBBBBBBBON
BGFCCCFGFFFGFCCCFGBBBBBBBBBO
BGFCFCFGFGFGFCFCFGBBBBBBBBBB
BGCFCFCGFFFGCFCFCGBBBBBBBBBB
BGGGGGGGGGGGGGGGGGBBBBBBBBBB
BBBBBBBBBBBBBBBBBBBBBBBBBBBE
HH]HH]HHHHHH]HHH]HHBBBBBBBBB
