28 24 0 1744
FORESEE
[[[BBBBBMCCCCC[CCDCACCDCDCCP
YVVB`CBMCD`ZCCCCCACACDDACLP[
CCCBCBMCDCAGACCACACCCCCCPDDD
GGGBBMCCCCCACADCCCCDCLPCBBDD
G^GBMCCADCCCCDACCXCLPDDDVCVD
GGGMDDDCCCACCDCCCLPGODDDVCVD
GGMDCDDDDCDCDDCLBBGFGODDVCVB
GCCCCADCCDACDLPFGGFGGGXCCVCB
MCBACCCBCCCLPGGGFGBBGGGODDDD
DCCDCACDCLPONGGBGBBGFGGWODDX
ADCDCCCLPBGGONGGGGFGGFGW[MKC
CBCBCLPGGBGGGONGGFGBGGGMKCAC
DCCCPGGGBGBGGGONGGGGGMBCBCDC
CLPCGGBBG`GBBGGONGGMKDCDCADC
P[BNGGGGBGBGGGGGOMKACCACCCCB
BADCCCCCGBGGGGGMXCDCBCCABCDP
DAVDDNCCCBGGGBKCDCCACACCCCPG
DAVDDDNBBBBMKCCCDCDDCCDDCPGG
DYVDDDDN[MKCCACMKGNDCACCPGGG
DDDDDDDMKCBCCCCIGGJBCCCPGGB\
DVDDDMC_CCAAACCIG`JCCDBGGGGW
DVDMKCCDDDDCDBDOLLPDCPGGGGWW
DMKDDCADDBCDACCCACCCPGGBGWW[
MCCBDDCDCDDCCDDDDCBPGGGGWW[[
