28 24 1 2244
RESERVE
11 23 11 18
CCCCCCCCCCCAGCCAVCCCCCSBCCAB
CABABACCCAACCACZVCCCCCTSCCAC
CABBBACVVVVVVVVVVCCCCCCCSCCC
CABABACVCJCCCCCCCCCMKKNCTSBC
CCCCCCCVAPCCBBBCCCBIBCACCCSC
CCCHHHHAAWCCCBCCCBCICGACNCUC
CCCWCCCAXCCCBBBCBCCICBAXJCCC
CCCHCHCCCCRQSCCACBCICAAGJCCB
CHCHCHHQQQU`TQQQSVCIBACCJCCC
CHCHCCAGACGGRSBCQCCOHHLLPCCC
CHHHHCMCBCGCTUCAQCCCIJCCCCVC
CHCCBGIGTQQWACACQCCBOJCCAVVC
CHBCCGI\CCCBCCBCTKNB[ONCCCVC
CHCCBGOLLLLHCCCCCBJB[[INCVVC
CHBCCGCHCBCOLLLLLLPB[MLPXVVC
CHHHHHHHCCCCCVCCCCCBMPCVCCVC
CCCCCCCCCCGGGAGGGHLLPCCVCCVW
LLLLLLLLLLLLLLLLLPCCCCCCCAGG
_CCCCVGG`GVGCCCCCCCCCCCCWBQB
CCVVCAABVBVVVVVCCCCWCWCWWGUG
CCAGCRACVCCCVBACVCCCBYBCW`BG
VCMNBTSCCFFCVBACVVCWCBCWWGVG
VCCCCCTQCCFCWWWWWVCCBCBCWGB`
WXIJBBBBBBF]V^ZZACCWCWCWWBVG
