28 24 0 600
charles
CAGDADGDDGDDYCAQZCAGACACABAA
CDCCDCCGCXCCDCCCPGBBCBBGBBBB
CDGDXDYDADDGADACEQCAACACABCB
CDDDCCCDCCDCCGCCCAPBBABBBGBG
CXCACDAGDXGDDDDCDCEQBABGABCA
CACDCCDCCGCCDXDCYCCCPAGAEAGB
CRRRADGDDDDDGCDADDCCEQBBCBAG
CWERCCXGDYGXDCDDDDXCACPGABBE
CRRRGCCCCCCCGCACCDDDDCEQBBAC
CRWDDDACCDDCCCCGCCCCCCC\PDBG
CRRRRRRRRRRRRRRRRRRRRRRRWQGB
BGEAFGEGGFBGGFGBGGGDGGDGGGCG
FFGBGGGFGBFABGGGMKKKKKKKKKNC
GBGGGFGGAGGFGGFGI````HGDGGJG
BMKNGGGMKNGBFGBGI`BBCHGHHGJG
GIWJGFGIWJFGGGGAI`BADHGGHDJG
GGAFGFGEGGGGFGBBI`BBGHHGHGJC
GAFGGGGGGFEAGBGFI`AGDGDGHGJG
BFGGMONAFMKOONGGIBBHHHHHHDJG
FGGGIHJBGIA^AJGBIBEHGDGGGGJC
FGFGIUJGGIWBWJFGIHHHGHEHBHJG
GGGGGGGBAIHBHJBGIDGGDHHHHHJD
GAFFGGFGCILELJFGIGHHGHGDGGJG
FB_GGFBGFGBBGBGGIGBLGDGLLGWD
