28 24 1 600
funtime
18 14 19 15
BUFABBBFBBBFBBBBBBBBBBBBBBFV
ACUBBBBBBFBFBFFFFFFFFFFFBBTB
BCFBBBFBFBBFBFBBBBBBBBBBZBFB
BGAFVBBFFFBBBFBFFFFFFFFFUFBC
CBCCGTBBFBFFFFBFBBBFBFFVBBCA
GYBACGUBBBBBFBBBBFBBBBVBCCBC
CBGBGACFFFFBFFFFFFBFFFGBBBCG
AGACGCBFBGG`GGGG`GGGBFAGACBA
CBCBBGAFGGRRRRSSSSSGGFCBCCCB
BCACCBBF`RBFBBBBF[BSGWCABCAC
BBBGBCBWGRBBBBFBBFBS`FCBCBCB
CBCACAGFGRFBFBBBABBSGFGCACAC
ABGBGBBFGRBBBFBBBBBSGFBCCBCB
CCACCAGWGRYFBBFBBBFS`WCACGBA
BGBGBBBF`R_BBBBFBB]SGFGCBACC
ACCABACFGGRRRRSSSSSGGFCCGCCC
BBGBCBGFBGGG`GGGG`GGBFBCAYCB
GAGCGAUFFFWFFFFWFFFFFFGBCBGC
BBACBVDDDDDDDDDDDDDDDDTGACBA
AGBGTDXDDDDXDDDDDDXDDDDVCCCC
CCGUDDDDDDDDDDDDDDDDDDDDUACB
CGTDDDDDDDXDDDDDXDDDDDDDDVGC
^VDDDDXDDDDDDXDDDDDDDDDYDDU\
UDDDDDDDDDDDDDDDDDDDXDDDDDDV
