28 24 3 600
savours
18 11 13 10
15 21 17 11
26 2 4 5
GCGGGDDGGDDGCGGDCCGCDGFFGGGG
GFFFFFFFMOKKKOKKOKKONGFFDFFG
DGGF[[GFIGGGGHBHGGGHJGFFGF]D
FFGF[FGFIWHHGHGH^FGHJCCCGFGG
CGGFFFGGIBBHGHGHHHXHJFFFFFGF
GFFFGFZGIBBHGHGGGGGGJGCGFFGF
GGGFGEFGIHHBABWWWWWGJGFDGCGF
FFCFGGGGIBDBBBGBGEBGJCFFFFFF
GGGFFFFFIGBHWHHHHHHGJDFGDGFF
CFFFGGCFIGHH`GHGGGGGJGFGFDFF
GFFFGFGFIGGH`GHGHHHHJGGGFGGG
GCGFCFGFIHGHGGHGHG]FJFFFFFFD
FFGFGFCFIHGHHHHGHHHHJZZZZZFG
FFCGGFGFIHGABGHGGGGHJZFFFFFG
FFFFFFGFIHGHHGHEYXGHJZZFDGGG
GCGGGFCFIGGHWGHHHHGHJFZFGFFF
GFFFGFGFIGHHWGGGGGGGJFZFGGGF
GFFGCFGGIGHWHHGHHHHGJFFFFFDF
CGFGFFFGIGGGHHGH\BHGJGDGGFGF
FGFGFFFGIHGFHGGHHGHGJGFFGFGC
FCFGCGCCIHGHHGHHFGHGJGDFGFFG
FGFFFFFFIZGHBGH]BGGGJFGFGDGG
FGFFFFFFIHLHHLHHLHXLJFGFFFFF
FGGCGGCGCCGCGCGGCGEEA_GDGDG`
