28 24 0 4744
FINALE
\GBGBVGGCGGGGGABGGGCGCCCCCCC
VVGVVVGBCGAABBACCBGCYCGGGBGC
BGCGBVMKNGCCAYBGMKNCBCCGCCGC
VVVAVVIHJGGGCCG_IHJCGCBGCGBG
BVGBBGOLPGBGGGGGOLPCGCCGCCCC
AVVBGGAAGBGMKNBGYGGCGBBGGGGC
BAABAGDDBCGIHJBBAAGCCCCCCCCC
AABDCBBABGGOLPHHWWWHHHHHHHBG
BBBCGAADGBCGWEHGGGGGGDGBGHCG
BADBGDDBGBHHWHHCHHHHHHBCGHCC
BBABGCGBCGHGGGHBCGGGAHDCBHCE
HHHHHHHHHHHCCCHAABBBBHHHHHHG
BDHDBDDHBCCCCCHBBCHHGH^GCGHG
BCDDDDBDCCDBBDHHHHHBCHBGADHG
DCCCBDDCBBDBGGHAHAHHGHGCBGHG
BBDDCCCBCDCBHGDBGBGCGHHHWHHC
HHHHHHHHHHHHHHHHHHHHHHHHWHHG
GGGDGBDGGGGBGGCGGXGGZGXWWHHG
GFHHHHHHHHGBGCCCGXGCCGHHHHHC
GGGDGGDGGHCBGGCGGHHHHHHHHBHG
HHHHHHHFGHGBAGGGGBGGGGG`G`HG
GGGDGGDGGHCBCCCGGBGGG`HHHHHC
GFHHHHHHHHHHHHHHHHHHHWHBBBBG
GGGCGGCGGGCGBGCGGCCGGGCGGGCG
