28 24 3 3244
CONTEST
4 17 0 19
0 1 27 19
0 23 15 0
CCCCBCCCBCCCYBV_IGGBCBCCABCC
]CBCCCBCCCBCCVVGIG`JCCCCXCCB
VVVVVVVVVVCVCAGGIBBJCBCCCCCC
BBBWWGGG`VCCCXGGOLLPCCCCCBCA
[BBBWWWGRQQQQQSGGGGGCACFACCC
[[BBBCWBBABBVAQWFGAGCCCCAACC
VVVVVCCCBBBCCCQVVVVVVCACACAC
[[BCACACBBBCVCQCCACCVAACCCCC
[[BCCAACBBBCVCUCBBBCVVVCVVVV
[[BCACCCBBBCCCCCAXVCCCBCBCWB
VVVVVVVVVVVVCVVVVVVVVVVCVVVV
ACCCCACCCCVCCCCCCCCCBCBVVGG`
^CCAAACCCCBCCVCMCKKNCBCBVBAG
GRQSCCACVVVVVVVIBBBJBCBCVCBC
`CCUCCCCVAABBBVOLLLPCBCBCBCB
BWCCCACCVBAABBVBCCCCBCBQQQQQ
GCCVVVVVVCCCCBVVCVVVCBCACBCC
\VVV]ZCCCCCCCCCCCVAVBCCXACBC
VVVVVVVVVVVVVVVVVVAVVVAVVVVV
GCCAVGVCCCACCCBCCCCCACCACBCG
CBBAV`VCXCACBCCCCCBCBCCCACCC
BCCBVGVCCCCCCBBCACACCACCCACC
BCCCVGVBGBACBBBBCCAACCBCCCAC
]BVCCACCCCABB[[BBCBCCACABCCC
