28 24 2 944
ILLEGAL
25 17 13 18
0 19 0 0
GCFGGCCDAAF[[[[[[[[[FXXDGCBB
FGFCFGFGBBDABAAAAAAAFBD``CCB
CBFCFGFGDFGBBBBBBBBBFCGRSGCC
FCFGFGFDGFFGGGBBGGGFCGGTUGGG
BCGBFBFBFFCGBGGGBGGFCACGGCAG
DFFFFBFBFFCGCGG^GBFAABBQBBBB
DFCGGFFDBFBGGGGBGFBBBCCQGGGG
CCDFCCFFFFCQGQGFGFQQQQQQQQGB
GFBFGDGCBFCQGBBBBBCGGGGCCGGC
GFFFFFCCBFBQ\GBBBFQQQQQQQQBG
CFEDCCGQQQQQQQQQBFBGCCGGCCGD
BBQQQBBQGYBGGGGQQQQQQQQQQQBC
QQQAQQQQBBABCACAABGQGCCCGGGC
GCCCCCGGGVCCACGABCGQBMKKKKKK
GBVVVVVBCVCVVGGVGBCQQICGCDCA
GVWGAGWVCVBVBVVVGCABBIGCGDCW
BVGGWGGVGVVVCBVCDGACBIAGGXGC
BVGABAGVCVAGBVBGKKKKNIDGX]XG
BVGWAWGVBVAAVGGDGDGAJIGGDXGC
]VAGAGAVBVBBVVVVVVBBJI``DD``
VVWGWGWVVVGBVBBBBVLLPOLLBLLL
CWGGGGGGBB_GCCCCCVKKNMKKBKKK
BVGGGGGCBDVFCVBBCVVVJIGDBAAA
BVDGZCCGGGVVBVDGCGDGBBDGBBBB
