28 24 3 944
APPEASE
16 18 12 22
20 23 0 23
20 10 25 1
GCGGGCGGCBGGCG\BBBBBBBBBBBBA
DBCGXXXGGDDDGDDBAMNCMNCMNGBB
GCGX^ECXGGGGGGGBBOPCOPCOPGBB
GDGGXXXCGBCDCDCBBBBBBBBBBBBC
GDCGG`G`GGVGGVGGG`G`G`GGGGCG
HHHHHHHVVVVVVVVVVVVVVVVVVVCG
BGCGGBHAAGVBGVAGYGAABVBGDVGY
GGGGCGHBBCVGCVDBBBACGVVVDVBB
BQQAGGHGGCVCGVDGGBCGAVBGGGBC
GTQAAGHGYCGAGGGGBGCCBVCGBCGC
BAQAADHCRQQQSDDDACBG]VCGBGGC
CRQAAGBGQB_CQBGRQQQQQQQQBQQQ
CQQQWGGCQCDBQBGQDGAAAQGDGQGB
GQ[QGGGDQBGDQCAQBGCBCQGGDQAG
BQCQGGGDQDYGQBBQGAQBQQCCGQCG
GQG[D[DGQGDGQQQQCAGGBQCGGQCA
GQQQQQQQQQBQQBBBGFBGCQGBCQAC
CBGGDQBDGCGBGCBGDQGDCQGGGQCG
VVVVGQCGCBGCBDGG]QCQGQGCGQAA
GWCCWQQQQQQQQQQQQQGQGQCGGQAC
CVVVVHBCGGGAGGGGBQBQEQGGGQCA
WGDGWHHHHHBHHHHAGTQQQQGQQQGC
VVVVGHBAACAGGAGDBGBCGHCGGWGG
GDGCZHBBCGCGGHGGBDGC]HG`G`G`
