28 24 0 600
teens
ACACCXCCGGCHAABGGGGAGH[[[HGZ
CGCGAHEHCHEHBBCGHHHHGH[[[HGG
AGHHHHHHGHHHHHGGGGCHDHHHHHGH
CCHEGYGHGCGXBHBRHH\HGHWHWGBH
CAHGGDGHCCGCHHHHEHHHGHGHGEGB
GFH```WCGGAGDDGGDGDGDGDWGBGG
ZZHHHHHBHHHHHHHHHHHHHHHHHHHW
ZZHAHAHCHWHBBBBHABDDDGDGDGGG
HHHWWWHGHZHBAABHBBGHHHHHHHFD
BBGCCCGCHDHBBBBHBAGHFBBBFHDG
HHHHHHHCHGHBRHHHGRGHBBFBBHGA
BGCCBGGGHDHAAAAGGHGHFBBBFHAC
GHHHHHHXHGBBBBBBSHGHBBFBBHCA
CGBHAWGGHHHHHHHHHHGHBBBBBHGC
CACHWEE^HDBGDDDDGDGGGYGYGGGG
CRHHHHHHHHHHHHHHHHHHHHHHHHSG
DDADDADDDDDBDADDADDDDDADBDDB
RDBDDBDFDADFDDDDBDADADDMKKND
DDDABDDDD_DMNDDRDADDBDEVLLWD
DDDDDDDADDAIJDDDDBDMNDADADDD
ADMKKNDDDDBDDDMNDDDIJDDDDDDR
DBTQWLDMKKKKNDTPDDDDDADMKNDD
DDDDDADVJOUWODBDDADDDDDVWPDB
BDRDDDDDADDDDDDDDEDRDDADDDDD
