28 24 0 600
weaken
BECRCCCCCCCBBCCBCAACBCCHAA_F
[BCCCCCCCCCECABACBCCCACGCECC
BBCCCCCCCCCBCCCABACBFCFFHRHC
ZBCCCYCXCCCFACCCCCCCFCACABCC
SBCCCCCCCCCBAABABEBAWCCCHBBA
ASCCCCCCCCCBACCCCACCHWBHBBCB
CBSCCCCCCCCBCCABCCCBHCCCCBFC
CACSBBBBBBBBWFWBHHHAHHAHHHHC
BCBCSBACCA`ACCFHCCGCGGABBACC
ACCAACCBCCCCCCCHCCBFGBHBCHCA
CACCHCCACBHCAFBHBSGFBBHACBCC
CCCAAHCCBHCBRBBHCHEFWHHCBYCB
BABECBHHHHCHHHHBCDWDHBHCCBCC
CCHACHY^WCCCB[WHCDADBAHCCCCB
CBCSCCCCCCCWWBCHACBBBBHGBBBB
FCAFHABCWBCWCCCBBBCABCHGEABF
CCRDBCBABACCCWCBCCABACAGWSBC
CHHHBHHHBHHHHHHHHHHBHHHHHHHC
GCCGBCCCDCCCGGCCCGCDCCCGCCCC
HHHHHHHHBRHHHBBHHHHBHHHHHHHH
BGBGG\HCDCCCBCGCCGCGAGGGCGAC
BMKNBMKNCMKNEBCCMKNCMKNGMKNC
CQTUCOLPCV[UBGGBIVLBTUVBOQUG
DDCCECDDDDBDDDGDDGDDWHWDDDBD
