28 24 0 600
cheaply
AAABAAAAAAHBBCBCACCCABDBCCCR
BBBBBBBBBBHBADDACCACBCACADAD
DDDDDDDDDDHBDABCCAHDACCACBBA
DBBRBBBRBDHHCDCCADARBCABDACC
DDDDDDDDDD_HBABACBDAHBADACCA
BABCBCBCDCBHCABBADADADDBDBCB
DACCACBACAAHACBACADHDABACCAC
CCBACCACCABHCBACCACABCAACACC
DCDCABBACCARHCCBCBCHBCCBCBCB
BABAACACACCCHACACCBACACACCCD
BBBBBDBBABABHCCAABCHBCBCCAAC
BBBABRACCCCARBBCCCBHHBHHHHRE
BAABBDCBCBCCDEHHHHRBBBCBBBBB
BBBABRADCCHHHHDABCCDBBBAHHBA
ABABHHHHHHAEWCCHBHABCBCRBBBR
HHRHABCBAABCHCBCHBBBHBHBCCHH
RDBECBAACCCCHCDDDDRHAZAHFCCC
CCACBABCAACAHBBBRHHDDBDDH^FC
CABCECCADDBDHDCDCBHBABABHBBB
CADADABDDAAHHRCACCHBBBBBHDBC
ADHDDADDADDHBBDFACDHHBHHBCAD
BDDBDDAEDBAHCDFFFBCACBCDBBBB
DADADACDACCHBBDBDBDSDHAAHBHC
EBBHBCHBCB\HCDBBBDDHBBDDBCDB
