28 24 3 600
padlock
9 2 16 11
17 2 20 0
3 23 3 23
BBBBBBBBBBBVAIAVCBCIGAGADBD^
B[BBBWWWWIBBB_CCCJBCJCBDDADA
BBBABBWBB]JUL\JIL]YBICFDBACD
BABBBBWBWJYBABB[AUXCUCABCBCD
BBABABBBBIBBBCABBICBICADCBDB
BBBBWWWWAUBABABBAJCCACDDBXBD
EABBB[BBBIBBBBBABIBCJCDBFBDD
ABBXBBBBAJCBABBBBLCCBIC`B`DZ
BABBBBABBIABFBVABJCWCCVLJIUL
BBBAWBABAJBBBAFDBUBCCCCCDCDD
BBBBABBBBLBAFBAABILIUJLIJILD
BBABBBXABIBB[FFBGLCCCCDDCCDD
ABBBBABBBLBILVILJFCWWWWWCWDD
BBBABBBBAJBAUBABAVCCCCDWBWAD
WBBBBBBBBTBBBBBBBIWWWWDDDWWD
KKKKKKKNBBVUBBABBLCCCCDWDWB`
JLILJIVABJXBABBABLWDWWWWDWBB
BBBBBABBBIBBBABBBTDDDCWDDFFX
CFBBABBWBJBBBBABBR`WWB`DFABB
CCFBBABBWBBBACBBAIDDWCWFBBBB
ACAFBBBBBIBCBBABBRWDWCWFABAL
B`BFBBABARBBBBBBBXBDDCDFBBWF
CACCFBBBBJIWWWILIJWWWWDFBXFB
WBB]BWBLBBBBBBBBBB`DDD`FBBBB
