28 24 2 3960
TAXABLE
9 17 22 19
26 0 21 11
ZAGGAGAGBAGBAGBAGAGBAGBAGA]B
ABBABBCAGBAGBBABAABACXABBCAB
BACBBABBAAACAGBABBGAABCBABAB
CBGBGAXGBBCBCACBAGBCBGABCGBA
GABCABBAGABAGBGACABAGABACABB
ABABABGCBAGBABABABCABBABBABA
MNMNBGMNBMNMNGBMNGMNMNBGMNMN
BBBBBBGDDCDDADCGADDGEGDADGAD
WLHHKLHGADGBDGYDDWDADDCDDGDG
WWWWWWHWDGD`DDDADDDDDDDGAWBD
WWWWWWKDGDDFFFFFFFFFFFDDDGDD
WWWWWLHGADF[FFWWWWFXFGFDDADC
WWWWKBBDDFYWFWWFFWFWWEWFDDWD
WWWWLBFFFWWWBWFWWWFWWWWFFDCD
WHHLFFAWWFFFBFFFBFFFBFFDDFDG
GDDF^WWWWWWFWWWFWWFFW`DD`FDD
DDFFFFFWXFWWWFFFFWFWWFFF`FDC
CDFFA\AFX]FWFWWWWWWWFAAAFFDE
QCFACCCAFFFFFFFFFFFFACCCAFDO
GDCACCCACDDDDDDDDDDDACGCA`DG
OCCCAAACCOCDWCXOCXCDDAAADDGW
DGWDCCCDCYDCPCCCDPCDDDDDDPDD
P_GDDGOBCQGDGDCDCCDOGDPDDGQD
[QDGCD`DCGDGIJDGCDQ`CDDGDGDG
