28 24 4 4784
ALGEBRA
9 10 19 23
10 3 15 5
15 12 19 23
15 3 12 1
BBBBB[B[BBBHBBBBXBBBBXBBBBBB
BBBBBBBBBB[HGBBBHB[[BHBBB[[B
BBB[BBBBBBBHBBHHHB[[BHBBBBBB
BBBBB[B[BB]HBBH]BBBBBHB[[[BB
BBHHHHHHHHHHBBHHHHHHHHBBBBBB
BBWBBBBBBBXBBBD`DBBHBBBB[`DD
BBHHHHHHHHHBBBDDDBBHXBBB[`DB
BBBBBBBBBBHBBBD[`BBHHBBBBBBB
B[BB[[[[BBHB[B[D[BBBHHBBB[[B
BBBBB[[BBBHBBBB[BBBBBHBB[[BB
BDD`BBBBB]HBBBBBBBBBBHBBBBBB
XHHHHHHHHHHHHHHHHB[BBHBHHHHB
BBHAFBBBBFBBFBB]HBB[BHBBBBBB
BBHBBBYFBBBBBBBBHB[BBHBBBHHW
BBHBBBBBBBBBYBBBHBB[BHBBBHBB
BBHBBBBFBBFBBBFBHBBBZHBBBHBB
BBHBFBBBBBBBBBBBHHHHHHBB`HBB
[[HBBBYWBBBBFB^BHBBBBBBBDHBB
HHHBBBHHHHHHHHHHHBBBBBBBDHBX
BBHYBBHBBBBBB[BBBBBBBBBBCHBB
BBHBBFHBB[B[BBB[BBB[[BB`DHBB
BBXBBFHB[BBHHHHHBBHHHHHHHHBB
BBHHHHHBBBBBBBBBBBHBBBBBBBBB
BBBBBBXBBBBB_\BBBBHGBBBBC`CB
