28 24 4 6000
BETTING
9 23 27 9
2 0 10 20
12 8 27 19
9 18 20 19
BB]WWWFBABDBGGAGBABHGHAHGGCG
BFAWFWAFBGABACBAGBGTCGCGCHHC
FAAWZWAAFCCGBADDADAVGWWWGHGG
AAABZBAAAFDAGBABBGVHGWBWAWYD
FAAWAWAAFGBLBAAAGAEKCWWWLHFG
ZFAAAAAFGBAHVHTHDBBFGWGWAZVB
WFAAWAAFAGBQGDGGGCGWGBBGWFVG
ABFAAAFGBBQFAGDKHHHFCCLHLHFG
BB\FAFGADFGG]GGFCCCCCCHAGGAB
BABFAFB^QGGGGGDAGGACDWTDBACG
BBFBXBFMNWGRUUUUSOQMNRSGABAB
AFCGBGBXBGGGB`GG_GBGBGFABACB
DGGGGGGCFGG`FGGFBBEGGGFAGBAG
GGGFFGGGGFGEGFFZFBGAGBFBBAC`
CGGGGGGGCGFGDBDACFGWGGFGABAG
GGXGGGGGGBGFBBBBCFFFFWFABABA
CGGGWFGGEGGGFWWFWCGCGGFBBCBW
GGGGGGGGGGFGA``WFGWGWGFAGAAG
BGGGGGGAG]FGW``WBGXGDGFFBAWB
GGGGGGGCGFFFFWWFCGDGGGGCF[AG
GYGBGGGGGFGGGGGCFBFIJGXGCFFF
GCGGGFGCGFGXGGXGCFWWCGGCGCGC
GGGGGGGGGFGGGGDAGFFWGGGGGZXG
BGBGGBGGF]GGGGGWGCBFGG`GGCGC
