28 24 4 600
advance
27 20 3 4
4 5 0 21
15 9 27 0
7 1 1 1
D`AGHHEGGGGGGFBGGGGGGFBGGGGG
`DWGGHH]MNGGFBGGMNGGFBGGMNGG
QQQSGGHHFGGGGFGBFGGGGFGBFGGG
^UGRSGGHHFBGGGBGGFBGGGFGGFBG
GGAGRSGGHHGGMNGGFBGGMNGGFBGG
GGWW]RSGGHHGFGGGGFGBFBGGGFGB
GRQSWRQSGGHHGFEGGGFGGFEGGGFH
GGGGGGGRSGGHHBGGMNGGBBGGGGHH
BUGGGGGGRSGGHHHHHHHHHHHHHHHH
UUKGKBKGGRSGGHH]BBBBBBWGGGG`
GGGGGGGGGGRSGGHHBBEBHHGGHHG\
IGJBIGIEJGGRSGGHHBBHHGGHHUUU
BGGGGGGGGGGGRSGGHHHHGGHHHDAD
KGIEKGIBKGIGGRSGGHHGGHHHHDAD
GGGGGGGGGGGGGGRSGGGGHHHHHDDD
LGLGLGLGLGLBLGGRSGGHHHHHHDXD
BGGGGGGGGGGGGGGGRSGGWBEBBDDD
IGJBIGIGJBIGJBIGGRSGGHHHHDDD
GGGGGAAGGGGGGGGGADRSGGHHHDXD
TTTTTTWGTTTTTTTTTDRQSGGHHDDD
VVVVVVVGVVVVVVVVVDRQQSGGHUU]
GYGGGGGGGGGGGGGGGADRQQSGG_UX
IJIKIJKDTDDTDDTDDTDRQQQSGUZB
[BBBEBBBVBBVBBVBBVDDDDDDDBBB
