28 24 3 600
baptise
12 20 18 0
2 9 23 20
26 4 6 23
G`GBCCGGGGGGGAGBFBGFBFBGGGBG
MNOPCCCCCCCCCCGGGFGFGGFFGFFG
CCCCCXCGTTTCCCGFGBGBBGGFBFGB
CXCCCCCTVVVTFGGFGFGFFFGFGFGF
CCACTTTVBBBVFBFBGFGFGBGFGF]G
RQSCVVVYBTBRQQQQQQSFGFFFGFBF
ECCCBBBBBVEAGGG`GG^FBGEGGGBB
HHHHHHHHHHHHHHWHHHHHHHHHHHHH
HZHHCCCCCCACCH`GGGGGGGG`HH\H
CB]HLCLXLCLCLHGMNGGCOPCGHGBG
B[BHCCCCCCCCCHGGGGGCCCCGHBFB
GAGHCLCLCLCLCHGMNGGCCCCGHBBB
HAHHCCCCCCCCCHGTGTGCCCCGHBAB
CCCHWRQQQQQQQHGVGVGCCCCGHHAH
CCCHGGGGGGGGXBGGGGGCCCCGHCCC
HEHHWRQQQQQQQHGTGTGCCCCGHHCH
ABAHCCCCCCCACHGVGVGCCCCGHAXA
CCCHCJCIEICICHGGGGGCOPCGHCCC
AAAHCCCCCCCCCHGTGTGGGGGGHAAA
CCCHICIXICJCIH`VGVGTGTWWHCCC
ACCHCCCCCCCC]HWHGGGVGVWGHC`A
CCARQQQQQQQQQQQQQQQQQQQQSACC
CACACCCAAAAYCHAAAHAHCCCAHCAC
C_CCAGGCCCCCCCCCCCCCAGGCCCCA
