28 24 3 600
lessons
15 8 1 14
15 2 27 0
23 2 0 23
BBBBBABBBBBKGGGYGGGKEDABGADG
DADAABAAABDIGFBDBFGKADDDDDDA
DDDDBKBBBDDIGRS]RSGIADA]DADD
WIIIIIBIIIWKAIITIIAKBDABDADD
XBBBBXBBBGGGDG^VEGCKDACAAAAD
JJBJJJJJJJJKGTTTTTGKDDDDBDDD
GGGGGGGGGGGKGVVVVVGIADDADGAD
CALLLLLLLGGKGGBGBGGKADDADAAD
GB`GGGG`LGGLKLK]KLKKCABADDDB
LBLLLLLLLKKKGGAGAGGKKKKIKKIK
KGLGGYGGGGZWGLLGLLGWGGGAEYGG
GGLLGLGLGLWLGL_B[LGIGIGIGIGI
GKLGGWAGGWXWGLL`LLGWGGGGGGGG
GGLLGLWLWLLLGBLGLBGLLLWIWIGI
KGLGGGGGGGGGGGWGWGGGGGGGGGGD
IJLIIIJIKIJLIIIILIKJILJIIIJI
CBFFFFF\CCCCCCCACAGGDDDLBDA[
CFCDDDEFFFFFFFAAAFDDDXDWDDDB
CFCFFFFFCCCCCFFAFFDDDDDLDADD
CFCFDDCDCFFFCFCCCFLKLLLKLLLD
CFCDDFFDDFCCCFCCCFAIAIAIYIAD
CFFFFFBCFCCFDDCCCWDDDDDDDDDD
CRQQQQQQSCRQQQQQQSIDIAIDIAID
GAGGGGGGGGGGGGG`GWDDDDDDDDDD
