28 24 3 600
zippers
15 13 0 0
13 11 27 0
15 11 3 16
GAGGGGGGGBGG`EHBBBFBBBBFBBBG
CIJIJIJIGIKIKIHBFBFBFFBFBFFB
CAGGCYCTGTCCCAHBFBFBBFBFBFBB
GMNGGCCVBVACCCHBFBFBBFBFBFFB
GGMNGGRQWQSCCCHBFBFBFBBFBBFB
AGGMNGGYCCCCCCHBFBBBFBFFFBFB
ZBCBMNGCAGCCCCHBFFFFFBBBBBFB
TGTTTTGOPGCXCCHBBBBBFFFFFFFB
VGVVVVGGGGCCCCHBFFFBBBBFBBBB
WGGGGGGGFGCCCCHBBBBFFBBFBFFF
LGLLLLGLLLLLLLHEFFFFFFBFBFF`
BGB[[WGGBGGGG]H]XBBBBBBFBBGG
HHHHHHHHHHHHHHHHHHHHHHHHHHHH
CYGJJJGWBHBCBAH]`GGGBXBGGGGE
GWGGGAGHHHACABHTTTTTTTTTGTTT
GJJJJJGHBBBCBBHVVVVVVVVVGVVV
GGHGHGGHBXBACBHBBBGGCAGGGGG[
HGAGAGHHHWHHHHHQQQQSARQQQQQQ
GGHAHCHCCCH`C`HGGGGG_GGGGGGB
GBGCBGHCHCHCCCHARQQQGQQQQQQQ
HHHHHGHBHCCCHBHCCCCHGHCCCCCD
`HCCHCHXHHHHHXHNCXCHGHCCBBBC
CBACHGGBGH^GACHCCCCHGHY`BBBC
CHCCBGHGGHBBC\HCCACBGBCCCCCC
