28 24 0 600
africa
WDZAWDCWDWA^HXKBAGBBKBRQSBKB
ADDDDADDADDDHBLBMKNBLBTVUBLB
DDDDGDGDDDGHBDFDOHPGDGDGDGAD
ADADDADADDHBHGFGDLGDGGBAGGKG
DGDDDDDMKKGGDGGDDGDGGBABAGHD
DDGADWHGGGGEFFFEGGBADABABDHB
DDGDGHGACGFFFFFFFGGDGBABADHG
DADMKCABGFFF[F[FFFGDDABABGHB
GCGHGGBCGFFFFFFFFFGGGBABADHG
KXKBBKKGDFFDDDDDFFGDYFFFFGLB
GCGBH\GKCGFFDQDFFGGDFFFFGGGG
KKKKHKCHWGGFFQFFGGGFFFFGGFAB
GCGGCGGLWGGFFQFFGGFFFFGGGBFG
`FKGHHHHWGGFUFTFDFFFFGGMKNGG
`WLBHGCGGGDFFFFFDFFFGDGIFJGG
GW[KBCBGGFDFFFFFDDFGGFBOHPBF
CFFLCGGGFFDDFFFFFGGGDGFBHBFW
GCCCBGGFFFFGGFFFFFGDDGFALAFG
AGAGAGFFFFGGGGFFFFFGGGDDBDDG
WGWGWGFFFDGGDGDFFFFFGDBGBGBG
GAGAGGFFFGAGYDGFFFFFGGGGDGGD
GWGWGGGFFFBDDGFFFFFFD_ADAWAD
GGAGGAAFFFFFFFFFFFFDGRQSRQSB
BGWGCBCZFFFFFFFFFFGDDTVUTVUZ
