28 24 2 600
working
6 22 25 23
8 14 22 20
GAACGGGACGW^WDGFWWFGDGAAGBAG
ABBGBGABGDFWFGGGGBGGABCBAGCG
CAAGACBGGGGGDGDFGAGBCBGGBAGB
GBCCBGGABADGGYGGDCGAGGCGABCA
CGCGABFFFFBGGWGFGGFFFFGBCGGC
GXCGCFGGAGGGFGGGDGDAGGFGCGXC
GGGGFCGMKNGBDGFBDGMKNGGFCGGG
BCGFACGOHPGDGGDDGGOHPGADFGAB
ZBFGBGAGHDDDDDDDDDDHDDFD`FBB
FFGGACBBHDXDDXDXDXDH`DDDD`FF
GABBCAGCHDDDDDDDDDDHDDBYDDDD
YBBBACBGHDDDXDDXDDDH`DDDDDD`
BGAGBGACHDDDDDDDDDDHDD`D`D`D
FFFFFFFBLDDDDAADDDDLBFFFFFFF
DDDDDDDD]MKNABAAMKNWDDDDDDDD
DFFFFFFFFOHPABABOHPFFFFFFFFD
DDDDDDDDDDHABABABHDDDDDDDDDD
FFFFFFFFFDHBABBBAHDFFFFFFFFF
DDDDDDDDDDHBAABABHDDADDDDDDD
DDDDDBDDDDHBABABBHADDDBDDDDD
DDD[BGDDDBHBBBBBAHBDDDGB[DDD
DD[BBRQSBBHAABABBHBBRQSBB[DD
D[BBBT]UBBLBABBABLBBTWUBB\[D
[BBBBBBBBFDDD_DDDDFBBBBBBGB[
