28 24 4 600
refract
16 23 12 23
19 14 2 18
2 17 4 4
11 10 0 13
BBBBBBBBBBBWG``GWBBBBBBBBBBE
BFFFFF[BABBWWWWWWBBABBFFFFFB
BFEBBBBBBBBBBBBBBBBBBBWBBZFB
BFBFFF[BBABBWBBABBABABFFFBFB
BFGFGWBBBBABBBBBBABBBBBBFBFB
BFBFWF[BBABBWBABBBBBBFFBFWFB
B[B[B[FBBBBBBBBBBBBFFBBBBBXB
BBBBBBBFABBAWBABBFFBBBABBBBB
BBABBBBBFBBBBBBFFBBABBYBBBBB
WBBBBBBBBFBEFFFBBBBBBBBBXBBB
GWBBABBYBBF]BXBZBBBBE[BBBBVG
`WABYBBXBBBF\FFFBBXBBBBBBBB`
`WBBBBBBBBEBFF_BFBBBBABBBBV`
GWBBBBBABBBBBBBBBFBBBBABBBBG
WBBEXBBBBBBBBFFFBBF]BBBBBBBV
BBBBBBBBBABFFBBBBBBFBBBBXBBB
BBBBBBBBBFFBBYBWBBBBFBBBBBBB
BB]BBBBFFBBBBABBEBBBBFBBBBBB
BFGFBFFABBBABBBWBABBB[FBFBFB
BFXFBBBBBBABBBBBBBBBBBBBFBFE
BFBFFFBABBBBBABWBBABB[FFFBFB
BFBBBBWBBABBBBBBBBBBBBBBWBFB
BFFFFFABBBAWWWWWWBBBB[FFFFFB
BBBBBEBBBBBWG``G]BBBBBBBBBB^
