28 24 4 600
receive
14 6 2 7
7 21 12 9
16 12 2 19
9 9 26 23
AF[ZDADAAA[AWCAWACWAA[AWWAFA
BDFWGCACCCACCGACCGCACADGWFGW
GDAFDADGADDDADADGADDDADAFW`W
KGWGFDDDAGAGDDADADAADDWFGWAF
ADWGGFAAAACAGACCACCCCAFAAGWG
AFGGWBFDDAA[AAWAAAAWWFWWDGFG
ADGGGGGFGDDAAD]DDADWFAWADADA
FGGGAGGWFADDAGAADAGFBDGDGWGF
GGGGXFGF[FDADAADDAFADGGGGGGA
AFGGDWGWW]FDGDDAGFADGGGXGGFA
DGGGGGGFWWWFFFFFFWWGGGGGGGCA
WGGGGGGWWWWW```DWWAWGGYGGGGW
FFFFFFFFFFFFWWWW]FFFFFFFFFFF
WAWWDAWHWXAYD```WWWWCAGWWGWA
WAGHWWHHWWFFWWWWBBDWWACGAAWC
WHAWWHHWWWFGGGGGGFAAWACWWAAA
WWCXWGWWWFDGGFGGGGFCWWAXAWAW
WWWGGGGWFDDGGXGBAGBFAAWWWAWA
WWWYGGGFBGGYG_GGWGGBFAAGAAAW
GMGFWWFGGGAABBBGCBGGBFWWAWAC
CHF[[FAGXGDDGWGGGGGGDGFWAGAA
`H[[FWW]BGGGCCGGFGGXBGWFAAWW
^[[FWWGGGGGGGGGGFGGGGGAGFAWA
[[FWWCGGGGBAGGGG\GGGFBWGWFGW
