10 10 1 300
simple
7 2 7 7
[QUGGGGGOH
ZUGGVFVGGI
ABGGV\V]GI
CGGGVGVGGI
GG_GV^VG`I
GGGGVGVGGI
DXGGVEVGGI
GGGGVGVGGI
AYGGVWVGGI
BBBGGGGGMH
